OBJECTID,TRACTCE10,GEOID10,NAME10,PLNG_REGIO,last_edited_date,GlobalID,Pop_Chng_per_SqMi_2000_2010,HousUnits_MonthOwnerCosts_toInc,Sel_Mo_Own_Costs_30pct_of_Incom,Pct_Sel_Mo_Own_Costs_30pct_Inc,HousUnits_Compute_RentPctIncome,Rent_Pct_of_Inc_More30Pct,PctRent_PctIncome_More30Pct,HousUnits_OwnRent_Compute,HousCosts_Units_30pctMore_Inc,PctHousCost_30pctMore_Income
1,910103,13045910103,9101.03,ARC 20,2015-05-21T18:32:35.000Z,{7CDEFB60-07B3-46A4-8565-0D9DE549F3D6},100.3,1369,433,31.6,553,233,42.1,1922,666,34.7
2,910104,13045910104,9101.04,ARC 20,2015-05-21T18:32:35.000Z,{A76747E9-98CA-41BD-B6B6-A4014FE1964E},201.1,2351,526,22.4,715,391,54.7,3066,917,29.9
3,910502,13045910502,9105.02,ARC 20,2015-05-21T18:32:35.000Z,{4C49C559-2382-41E0-905F-FA22C0C2B2AE},-368.8,228,58,25.4,689,411,59.7,917,469,51.1
4,910800,13045910800,9108,ARC 20,2015-05-21T18:32:35.000Z,{2808E4EA-DDCC-4E25-80C3-FB561B95B72C},1.1,1029,224,21.8,347,122,35.2,1376,346,25.1
5,910101,13045910101,9101.01,ARC 20,2015-05-21T18:32:35.000Z,{E5A2A31C-1394-41CB-BCF8-12823E5B3A3A},397.3,1246,359,28.8,970,486,50.1,2216,845,38.1
6,910200,13045910200,9102,ARC 20,2015-05-21T18:32:35.000Z,{0BA64875-946A-4BFF-8A9D-32D9BDE8A88A},93.9,3389,960,28.3,820,385,47,4209,1345,32
7,910900,13045910900,9109,ARC 20,2015-05-21T18:32:35.000Z,{C407F8DB-2DE5-4112-878D-9AB47064515C},7.8,1026,241,23.5,224,130,58,1250,371,29.7
8,910300,13045910300,9103,ARC 20,2015-05-21T18:32:35.000Z,{772CF99F-3DAF-4AE1-ADA5-0E0434718D4A},17.1,1548,443,28.6,580,328,56.6,2128,771,36.2
9,911100,13045911100,9111,ARC 20,2015-05-21T18:32:35.000Z,{45C6C04E-16AC-4A09-A4EB-2524E16CC1A9},24.2,1650,322,19.5,1315,710,54,2965,1032,34.8
10,911000,13045911000,9110,ARC 20,2015-05-21T18:32:35.000Z,{5A05E6E6-51D6-489C-AB37-1F5D01A95BD0},27.2,1477,266,18,751,458,61,2228,724,32.5
11,910701,13045910701,9107.01,ARC 20,2015-05-21T18:32:35.000Z,{9EF16FBA-6901-42C4-B604-ADE56ED9F9AF},116.1,1732,550,31.8,1199,736,61.4,2931,1286,43.9
12,910703,13045910703,9107.03,ARC 20,2015-05-21T18:32:35.000Z,{6ACFE4B2-0C60-43CA-8DBB-A3E0A4AB6660},68.9,1839,573,31.2,891,521,58.5,2730,1094,40.1
13,910600,13045910600,9106,ARC 20,2015-05-21T18:32:35.000Z,{5A62E058-BDE8-4645-A4EB-1DDBD79F0D3E},70.5,1543,339,22,578,394,68.2,2121,733,34.6
14,910501,13045910501,9105.01,ARC 20,2015-05-21T18:32:35.000Z,{053E0617-9F62-4CED-BCB4-B7EABC7FA39A},153.2,751,288,38.3,1359,858,63.1,2110,1146,54.3
15,910702,13045910702,9107.02,ARC 20,2015-05-21T18:32:35.000Z,{BF632A40-A546-44C5-83EF-8A9E2383DC38},104.1,2296,543,23.6,274,167,60.9,2570,710,27.6
16,911200,13045911200,9112,ARC 20,2015-05-21T18:32:35.000Z,{0A7E6861-6DD3-418E-8B6F-ADF57A71F123},2.8,1628,516,31.7,498,282,56.6,2126,798,37.5
17,910400,13045910400,9104,ARC 20,2015-05-21T18:32:35.000Z,{25184685-C118-477F-8A3F-650132C21A92},-8.5,915,225,24.6,354,158,44.6,1269,383,30.2
18,140207,13113140207,1402.07,ARC 10,2015-05-21T18:32:35.000Z,{409F2455-126D-4B34-8B13-B6588CD5A2BD},49,1736,395,22.8,373,132,35.4,2109,527,25
19,140208,13113140208,1402.08,ARC 10,2015-05-21T18:32:35.000Z,{A3CC3456-45B2-49D5-93C0-DC63E3FFFB0C},435.5,1763,499,28.3,794,290,36.5,2557,789,30.9
20,140303,13113140303,1403.03,ARC 10,2015-05-21T18:32:35.000Z,{BCB8BD67-0FD1-49E1-914B-3CDB5337F6EB},-88.6,1245,345,27.7,387,211,54.5,1632,556,34.1
21,140304,13113140304,1403.04,ARC 10,2015-05-21T18:32:35.000Z,{6DFA99AA-807C-4BC9-A56D-701C02078A35},-109.8,1780,553,31.1,413,205,49.6,2193,758,34.6
22,140307,13113140307,1403.07,ARC 10,2015-05-21T18:32:35.000Z,{543039DA-D1A7-432B-BDBF-68EF72473335},123.4,1421,357,25.1,69,58,84.1,1490,415,27.9
23,140408,13113140408,1404.08,ARC 10,2015-05-21T18:32:35.000Z,{EA76240B-1B2C-49B3-BF7F-C3D286EAB1D7},-26.1,1030,228,22.1,60,16,26.7,1090,244,22.4
24,140407,13113140407,1404.07,ARC 10,2015-05-21T18:32:35.000Z,{7F9AFB6E-F686-4BE2-A218-007FE1BA976D},195.1,2102,473,22.5,837,535,63.9,2939,1008,34.3
25,140405,13113140405,1404.05,ARC 10,2015-05-21T18:32:35.000Z,{A8E7D5D0-156B-4461-91F7-81605CF04A2C},14.3,1104,267,24.2,83,48,57.8,1187,315,26.5
26,140404,13113140404,1404.04,ARC 10,2015-05-21T18:32:35.000Z,{E29C94FD-B96D-4292-8334-97A4A25E4723},179.3,1593,381,23.9,299,162,54.2,1892,543,28.7
27,140206,13113140206,1402.06,ARC 10,2015-05-21T18:32:35.000Z,{2DB3CA56-A9EE-457E-8F83-D2104D0F21D5},161.4,1233,318,25.8,274,132,48.2,1507,450,29.9
28,140203,13113140203,1402.03,ARC 10,2015-05-21T18:32:35.000Z,{375683F0-73FD-417C-B07E-7BF323388FB2},216.4,1584,493,31.1,229,125,54.6,1813,618,34.1
29,140204,13113140204,1402.04,ARC 10,2015-05-21T18:32:35.000Z,{43606EA2-36DA-4413-925F-5389002FC348},42.5,1414,404,28.6,232,144,62.1,1646,548,33.3
30,140305,13113140305,1403.05,ARC 10,2015-05-21T18:32:35.000Z,{37F50761-59D6-425C-920B-E5A0740EEF72},247.1,1208,268,22.2,244,151,61.9,1452,419,28.9
31,140403,13113140403,1404.03,ARC 10,2015-05-21T18:32:35.000Z,{096A988E-5C89-40B6-85FD-EFA96DDE4DAC},122.7,1824,508,27.9,148,78,52.7,1972,586,29.7
32,140406,13113140406,1404.06,ARC 10,2015-05-21T18:32:35.000Z,{657AACB7-0395-4294-92D7-F13E4192EDE4},37.3,1202,375,31.2,256,159,62.1,1458,534,36.6
33,140306,13113140306,1403.06,ARC 10,2015-05-21T18:32:35.000Z,{96169636-95B3-4036-8C5A-C89F5F6F3B87},56.3,1807,362,20,833,357,42.9,2640,719,27.2
34,140102,13113140102,1401.02,ARC 10,2015-05-21T18:32:35.000Z,{69951B01-0A77-445A-898E-B9EA9DBC64EC},-3.8,1875,417,22.2,97,23,23.7,1972,440,22.3
35,140101,13113140101,1401.01,ARC 10,2015-05-21T18:32:35.000Z,{675102DD-F719-4340-AE10-234C8A9466A5},49.1,2444,818,33.5,120,56,46.7,2564,874,34.1
36,140502,13113140502,1405.02,ARC 10,2015-05-21T18:32:35.000Z,{96F8B6E4-59A7-43AC-91E7-08F14301E906},12.4,1129,340,30.1,64,57,89.1,1193,397,33.3
37,140501,13113140501,1405.01,ARC 10,2015-05-21T18:32:35.000Z,{57439C85-42D8-4C0B-96D2-117337539484},42.3,1845,568,30.8,70,50,71.4,1915,618,32.3
38,060404,13247060404,604.04,ARC 10,2015-05-21T18:32:35.000Z,{F8AFDA44-A7DD-4755-9FD6-FFCA97F92272},-45.3,1726,421,24.4,365,227,62.2,2091,648,31
39,060304,13247060304,603.04,ARC 10,2015-05-21T18:32:35.000Z,{168847DC-2E18-4C52-9760-AE61E8C58D4D},120.7,965,385,39.9,1009,479,47.5,1974,864,43.8
40,060101,13247060101,601.01,ARC 10,2015-05-21T18:32:35.000Z,{69E1E1B2-9B32-47A0-93D4-7C01A7BEEEB8},9.5,960,277,28.9,191,60,31.4,1151,337,29.3
41,060202,13247060202,602.02,ARC 10,2015-05-21T18:32:35.000Z,{1AEE09FF-3BD2-42F1-9068-B339AD0FC431},174.6,2694,732,27.2,720,345,47.9,3414,1077,31.5
42,060201,13247060201,602.01,ARC 10,2015-05-21T18:32:35.000Z,{12AB91B7-89E7-4497-9AFE-1BFD86920F7E},31.8,787,277,35.2,252,191,75.8,1039,468,45
43,060306,13247060306,603.06,ARC 10,2015-05-21T18:32:35.000Z,{0B5E0CA3-2389-4D03-B247-9ED85E1A446C},231.9,720,215,29.9,201,58,28.9,921,273,29.6
44,060407,13247060407,604.07,ARC 10,2015-05-21T18:32:35.000Z,{6FA0658C-790B-4ED2-8BDD-EF79D4941720},-84.8,957,303,31.7,266,65,24.4,1223,368,30.1
45,060403,13247060403,604.03,ARC 10,2015-05-21T18:32:35.000Z,{E4C33F98-9CF3-4909-B4A5-64E36349FFA4},63.8,1059,475,44.9,120,52,43.3,1179,527,44.7
46,060406,13247060406,604.06,ARC 10,2015-05-21T18:32:35.000Z,{F730B047-E3DD-4700-A145-E03A1898EC59},41.4,1436,322,22.4,349,197,56.4,1785,519,29.1
47,060305,13247060305,603.05,ARC 10,2015-05-21T18:32:35.000Z,{7AFD6044-1E09-4391-B1D9-4DFDD1C15A19},138.2,633,176,27.8,1231,738,60,1864,914,49
48,060309,13247060309,603.09,ARC 10,2015-05-21T18:32:35.000Z,{0C4A99BD-6B46-485F-9A57-E183EE80E23B},323.4,993,213,21.5,814,459,56.4,1807,672,37.2
49,060308,13247060308,603.08,ARC 10,2015-05-21T18:32:35.000Z,{D64B11C9-6D47-4132-8AAA-E44A5EBD5D97},858.7,1087,347,31.9,1505,963,64,2592,1310,50.5
50,060405,13247060405,604.05,ARC 10,2015-05-21T18:32:35.000Z,{E26A2BBF-BEA6-43D8-9835-2576A22305A4},90.6,2146,717,33.4,191,86,45,2337,803,34.4
51,060307,13247060307,603.07,ARC 10,2015-05-21T18:32:35.000Z,{DEFA6706-4202-452D-B953-B0C17234AFCA},483.7,2404,876,36.4,1036,485,46.8,3440,1361,39.6
52,060102,13247060102,601.02,ARC 10,2015-05-21T18:32:35.000Z,{61448A40-0A29-432B-A828-BFDA987A7E12},35.7,1452,503,34.6,463,291,62.9,1915,794,41.5
53,030330,13067030330,303.30,ARC 10,2015-05-21T18:32:35.000Z,{D295C2C1-73EE-4FFB-AFA3-1DBC4F22F41E},139.1,1741,424,24.4,179,147,82.1,1920,571,29.7
54,030328,13067030328,303.28,ARC 10,2015-05-21T18:32:35.000Z,{964EEF2C-4B4B-48D4-B701-ACC0584AC486},-113.8,2099,407,19.4,191,162,84.8,2290,569,24.8
55,030700,13067030700,307,ARC 10,2015-05-21T18:32:35.000Z,{7ED8698D-BFB6-4F1F-90DB-B5599B500272},-708.2,604,234,38.7,871,414,47.5,1475,648,43.9
56,030324,13067030324,303.24,ARC 10,2015-05-21T18:32:35.000Z,{ACADD733-8ACC-4124-818C-09DE080E5E40},-220.7,1111,258,23.2,95,33,34.7,1206,291,24.1
57,030312,13067030312,303.12,ARC 10,2015-05-21T18:32:35.000Z,{9CACB18F-DE12-4A68-A75F-A97C3041857B},-80.3,2117,613,29,298,116,38.9,2415,729,30.2
58,030228,13067030228,302.28,ARC 10,2015-05-21T18:32:35.000Z,{AD2298F7-0F12-4AD5-834B-FA23932C945C},27.8,885,239,27,1941,1098,56.6,2826,1337,47.3
59,030231,13067030231,302.31,ARC 10,2015-05-21T18:32:35.000Z,{47E7C1FD-237D-4C86-85F3-EC63A3B18033},147,2550,480,18.8,70,38,54.3,2620,518,19.8
60,030230,13067030230,302.30,ARC 10,2015-05-21T18:32:35.000Z,{6CFC142E-9A93-4592-ABCE-1E6661178240},1275.2,3173,941,29.7,1983,919,46.3,5156,1860,36.1
61,030311,13067030311,303.11,ARC 10,2015-05-21T18:32:35.000Z,{47265E70-8409-41B2-A838-CAC9C130D694},-90,1920,344,17.9,261,56,21.5,2181,400,18.3
62,031001,13067031001,310.01,ARC 10,2015-05-21T18:32:35.000Z,{DC35B415-4C7E-4BAD-9DF7-B8579DD1E64C},-50.5,501,101,20.2,1108,699,63.1,1609,800,49.7
63,030310,13067030310,303.10,ARC 10,2015-05-21T18:32:35.000Z,{EECC26A3-1341-4748-8B79-E88EAA12EB42},86.8,2138,561,26.2,499,368,73.7,2637,929,35.2
64,030215,13067030215,302.15,ARC 10,2015-05-21T18:32:35.000Z,{4C6AB69E-0DD8-4CE8-9E43-2DA1C890E219},364.3,2605,628,24.1,344,189,54.9,2949,817,27.7
65,030601,13067030601,306.01,ARC 10,2015-05-21T18:32:35.000Z,{6E546DC6-9D90-4674-A0E2-47C0E651472F},1384.4,979,301,30.7,3098,1423,45.9,4077,1724,42.3
66,030227,13067030227,302.27,ARC 10,2015-05-21T18:32:35.000Z,{B0EDF665-DA64-48A6-84D2-51D6D8852052},87.9,1434,310,21.6,1217,642,52.8,2651,952,35.9
67,030602,13067030602,306.02,ARC 10,2015-05-21T18:32:35.000Z,{1F99B1BF-E7FB-4300-B174-79F3F7471B1C},61,1912,613,32.1,1026,510,49.7,2938,1123,38.2
68,030506,13067030506,305.06,ARC 10,2015-05-21T18:32:35.000Z,{7CE4C3CB-A6B0-46FB-91F2-2726E188AA0A},267.1,1099,273,24.8,692,260,37.6,1791,533,29.8
69,030507,13067030507,305.07,ARC 10,2015-05-21T18:32:35.000Z,{AB85CEB4-A6EE-40DF-89DE-8A063EEC97F2},51.3,1599,505,31.6,278,212,76.3,1877,717,38.2
70,030229,13067030229,302.29,ARC 10,2015-05-21T18:32:35.000Z,{68ED9E51-35C8-4C17-AC8E-342287FEFC0A},409.8,654,172,26.3,332,228,68.7,986,400,40.6
71,031208,13067031208,312.08,ARC 10,2015-05-21T18:32:35.000Z,{2D8B8ADA-8F82-4040-9F66-64C12F5A5683},960.7,583,65,11.1,2436,605,24.8,3019,670,22.2
72,031207,13067031207,312.07,ARC 10,2015-05-21T18:32:35.000Z,{867B09DF-DAD8-4F90-98F6-F854447D532E},176.4,500,179,35.8,1544,647,41.9,2044,826,40.4
73,030226,13067030226,302.26,ARC 10,2015-05-21T18:32:35.000Z,{C14B3357-002C-4262-83C6-C209591993D2},1151.9,2408,499,20.7,802,498,62.1,3210,997,31.1
74,031505,13067031505,315.05,ARC 10,2015-05-21T18:32:35.000Z,{81DD4CAC-855E-40C7-B5C1-DBBCFD15E095},-27.4,1679,414,24.7,273,208,76.2,1952,622,31.9
75,030313,13067030313,303.13,ARC 10,2015-05-21T18:32:35.000Z,{A38DF7C6-24A8-44D5-A2B6-C1F8677D1AC3},201.1,2186,632,28.9,500,125,25,2686,757,28.2
76,031310,13067031310,313.10,ARC 10,2015-05-21T18:32:35.000Z,{A6788D00-3BC9-41D5-9C6B-A2FBDBBC58FD},244.1,605,335,55.4,1734,1110,64,2339,1445,61.8
77,030214,13067030214,302.14,ARC 10,2015-05-21T18:32:35.000Z,{026CBE27-3036-4B4F-8762-92100E558BBE},299,2342,641,27.4,427,129,30.2,2769,770,27.8
78,031212,13067031212,312.12,ARC 10,2015-05-21T18:32:35.000Z,{27E9AFF3-5193-463E-9CA3-D160D47F747A},-71.3,932,209,22.4,24,0,0,956,209,21.9
79,031211,13067031211,312.11,ARC 10,2015-05-21T18:32:35.000Z,{81DDE685-21EC-4CF3-8572-876ECC20E90B},-73.3,295,197,66.8,1858,605,32.6,2153,802,37.3
80,031209,13067031209,312.09,ARC 10,2015-05-21T18:32:35.000Z,{816BFB4F-B871-497E-BDCE-E2B8E9C5359F},600.8,1422,351,24.7,176,133,75.6,1598,484,30.3
81,030224,13067030224,302.24,ARC 10,2015-05-21T18:32:35.000Z,{FD7366F9-1572-4FA1-80C5-8300E25753C0},1697.2,2015,592,29.4,380,155,40.8,2395,747,31.2
82,031205,13067031205,312.05,ARC 10,2015-05-21T18:32:35.000Z,{1F1FD356-5C22-4C48-B8BD-4BBBD1144E2A},688.6,1820,497,27.3,985,413,41.9,2805,910,32.4
83,031206,13067031206,312.06,ARC 10,2015-05-21T18:32:35.000Z,{BA07302B-5B05-4FFF-B91D-8A26D05FCF9E},1112.2,2134,468,21.9,2169,685,31.6,4303,1153,26.8
84,030220,13067030220,302.20,ARC 10,2015-05-21T18:32:35.000Z,{4B993083-EACD-4DFD-B537-339F45059674},-44.3,438,62,14.2,155,137,88.4,593,199,33.6
85,030905,13067030905,309.05,ARC 10,2015-05-21T18:32:35.000Z,{024DE4E8-7AC7-48E8-8EF3-8B9AF4C26432},398.3,1321,393,29.8,392,201,51.3,1713,594,34.7
86,030502,13067030502,305.02,ARC 10,2015-05-21T18:32:35.000Z,{72844EFC-4EB6-4BD0-BE15-BCA908052411},114.1,2047,389,19,370,149,40.3,2417,538,22.3
87,030209,13067030209,302.09,ARC 10,2015-05-21T18:32:35.000Z,{15726A50-98D9-4E00-947D-EA743B65BF2E},253.6,2270,407,17.9,92,30,32.6,2362,437,18.5
88,030326,13067030326,303.26,ARC 10,2015-05-21T18:32:35.000Z,{9236D464-46AE-4B7B-9EDA-0FABB87A417F},-70.4,1345,299,22.2,81,10,12.3,1426,309,21.7
89,031108,13067031108,311.08,ARC 10,2015-05-21T18:32:35.000Z,{1DA13E55-E23C-49D9-A17F-9503699EDBBE},-380.8,1105,408,36.9,1427,919,64.4,2532,1327,52.4
90,130105,13117130105,1301.05,ARC 20,2015-05-21T18:32:35.000Z,{8541BE1C-A4DA-4491-A143-4C8AC6F2F90B},106.5,352,149,42.3,295,216,73.2,647,365,56.4
91,130205,13117130205,1302.05,ARC 20,2015-05-21T18:32:35.000Z,{27B4CB35-3EB4-402B-A2CB-7AB51274BF34},113.9,500,178,35.6,124,77,62.1,624,255,40.9
92,130603,13117130603,1306.03,ARC 20,2015-05-21T18:32:35.000Z,{45EC21E0-4A38-4486-B973-6E1B0E502DF2},391.4,1041,204,19.6,124,124,100,1165,328,28.2
93,130610,13117130610,1306.10,ARC 20,2015-05-21T18:32:35.000Z,{FAC81BCC-C98D-4616-9122-9635FA17A749},125.9,1263,402,31.8,94,0,0,1357,402,29.6
94,130606,13117130606,1306.06,ARC 20,2015-05-21T18:32:35.000Z,{B12BF9B9-F34A-4916-8257-9403268BE452},263.5,1173,295,25.1,291,197,67.7,1464,492,33.6
95,130604,13117130604,1306.04,ARC 20,2015-05-21T18:32:35.000Z,{BFF9805A-6257-46AC-BEF8-ECEE082D75C8},693.6,1532,366,23.9,83,37,44.6,1615,403,25
96,130611,13117130611,1306.11,ARC 20,2015-05-21T18:32:35.000Z,{06BB68FC-27AD-4B6C-84FF-0005DFA48349},633.3,1005,184,18.3,17,12,70.6,1022,196,19.2
97,130609,13117130609,1306.09,ARC 20,2015-05-21T18:32:35.000Z,{FB67C0E4-10D0-45B9-BF20-C33361A949CB},1147.7,1229,209,17,39,0,0,1268,209,16.5
98,130607,13117130607,1306.07,ARC 20,2015-05-21T18:32:35.000Z,{8F501279-36DC-4D5D-996B-618F3238E71A},1206.3,1454,367,25.2,90,12,13.3,1544,379,24.5
99,130605,13117130605,1306.05,ARC 20,2015-05-21T18:32:35.000Z,{6F6113D3-CBE7-422A-9661-7F2A4AADA920},684.5,1269,333,26.2,76,26,34.2,1345,359,26.7
100,130602,13117130602,1306.02,ARC 20,2015-05-21T18:32:35.000Z,{F3447448-1AE0-48C5-99BB-0898BBD61403},810.9,1227,298,24.3,278,36,12.9,1505,334,22.2
101,130508,13117130508,1305.08,ARC 20,2015-05-21T18:32:35.000Z,{519CA99D-56F3-4DFB-B960-572D4ACD853A},491.8,1475,269,18.2,139,139,100,1614,408,25.3
102,130507,13117130507,1305.07,ARC 20,2015-05-21T18:32:35.000Z,{2ACD14B4-A971-4EC0-B0C9-5B96DF194CAB},80,817,232,28.4,115,59,51.3,932,291,31.2
103,130409,13117130409,1304.09,ARC 20,2015-05-21T18:32:35.000Z,{BCECDB36-BFC0-4AB7-AED2-18573D655FF3},201.7,579,132,22.8,194,104,53.6,773,236,30.5
104,030218,13067030218,302.18,ARC 10,2015-05-21T18:32:35.000Z,{97D72D66-2294-47E4-B80C-5E48C81540D9},455.4,1538,317,20.6,102,64,62.7,1640,381,23.2
105,030219,13067030219,302.19,ARC 10,2015-05-21T18:32:35.000Z,{3F1D6735-E1C4-4786-AF8C-48F209762B56},572.9,2890,810,28,98,31,31.6,2988,841,28.1
106,030235,13067030235,302.35,ARC 10,2015-05-21T18:32:35.000Z,{6637B717-BCC7-4F66-B826-2757B742D420},120.8,1396,244,17.5,105,68,64.8,1501,312,20.8
107,030234,13067030234,302.34,ARC 10,2015-05-21T18:32:35.000Z,{88738E97-A5CA-479F-8505-F410110420A3},376.7,1705,496,29.1,128,33,25.8,1833,529,28.9
108,030233,13067030233,302.33,ARC 10,2015-05-21T18:32:35.000Z,{78220E7B-BE6B-4BF9-B866-FF603549DEDF},-1.1,1425,314,22,67,17,25.4,1492,331,22.2
109,030337,13067030337,303.37,ARC 10,2015-05-21T18:32:35.000Z,{5FD1E72E-8795-4BCF-8794-B522E1D919D1},6.1,1517,362,23.9,108,70,64.8,1625,432,26.6
110,030334,13067030334,303.34,ARC 10,2015-05-21T18:32:35.000Z,{AAD195A3-8DE2-4109-B8FC-8D3C35399707},-140,1081,297,27.5,108,40,37,1189,337,28.3
111,031111,13067031111,311.11,ARC 10,2015-05-21T18:32:35.000Z,{CCC02AE7-D02D-46FC-9CDC-CD573E590C0B},-353.8,1178,335,28.4,520,139,26.7,1698,474,27.9
112,031110,13067031110,311.10,ARC 10,2015-05-21T18:32:35.000Z,{0C36E91D-473A-48BC-B437-274BC723582E},-166,889,232,26.1,541,338,62.5,1430,570,39.9
113,030405,13067030405,304.05,ARC 10,2015-05-21T18:32:35.000Z,{8FE62DB7-D48A-4946-81E2-4B5A601DAABA},-74,1312,397,30.3,1469,856,58.3,2781,1253,45.1
114,031101,13067031101,311.01,ARC 10,2015-05-21T18:32:35.000Z,{3F5B00E5-B025-414D-80A8-BBE111C46EF8},34.6,732,260,35.5,785,429,54.6,1517,689,45.4
115,130305,13117130305,1303.05,ARC 20,2015-05-21T18:32:35.000Z,{A3049894-AEE4-41AF-A112-A042225E067E},610.3,1201,500,41.6,88,24,27.3,1289,524,40.7
116,130301,13117130301,1303.01,ARC 20,2015-05-21T18:32:35.000Z,{25E6FCFB-09A5-4376-B930-6D66BDB11C4C},240.6,1317,400,30.4,116,88,75.9,1433,488,34.1
117,130405,13117130405,1304.05,ARC 20,2015-05-21T18:32:35.000Z,{3C3534C8-5518-4FAE-A7D0-075CDED89A48},542.1,1015,311,30.6,112,91,81.3,1127,402,35.7
118,130504,13117130504,1305.04,ARC 20,2015-05-21T18:32:35.000Z,{FA4FDC3B-B8B1-41DA-9947-B4333444C4C2},64.7,1039,209,20.1,261,156,59.8,1300,365,28.1
119,130505,13117130505,1305.05,ARC 20,2015-05-21T18:32:35.000Z,{F9AF5AE5-1CC4-4745-8F2C-032CFF6E7CE0},74.6,1002,289,28.8,41,24,58.5,1043,313,30
120,130503,13117130503,1305.03,ARC 20,2015-05-21T18:32:35.000Z,{F0FB0ABA-2825-42CA-BFB0-26641C7EA3BC},70.7,727,311,42.8,92,72,78.3,819,383,46.8
121,130102,13117130102,1301.02,ARC 20,2015-05-21T18:32:35.000Z,{D38D9732-BBE7-4934-8083-EC72DFBD5D08},207.4,869,193,22.2,68,54,79.4,937,247,26.4
122,130103,13117130103,1301.03,ARC 20,2015-05-21T18:32:35.000Z,{7D28A78D-5221-4181-8A96-DEC76542365A},190.1,879,279,31.7,148,85,57.4,1027,364,35.4
123,130303,13117130303,1303.03,ARC 20,2015-05-21T18:32:35.000Z,{8F0B9DD1-1B0E-4CC8-9A75-639A7EF53AD0},111.4,1065,240,22.5,59,43,72.9,1124,283,25.2
124,130201,13117130201,1302.01,ARC 20,2015-05-21T18:32:35.000Z,{1A74F433-D9C0-41BD-94E7-7432CB03693C},221.6,1206,318,26.4,147,82,55.8,1353,400,29.6
125,030232,13067030232,302.32,ARC 10,2015-05-21T18:32:35.000Z,{C91EDFA9-6702-40C9-8FB3-0702A9F2C04B},231.8,1640,425,25.9,191,90,47.1,1831,515,28.1
126,030222,13067030222,302.22,ARC 10,2015-05-21T18:32:35.000Z,{42C4AC4F-0164-4723-AB14-9ADD0C22BCDB},-31.1,1623,466,28.7,294,153,52,1917,619,32.3
127,031118,13067031118,311.18,ARC 10,2015-05-21T18:32:35.000Z,{9C438BEB-2F87-4D34-8A31-883AB40AFED7},133,1523,416,27.3,761,379,49.8,2284,795,34.8
128,031117,13067031117,311.17,ARC 10,2015-05-21T18:32:35.000Z,{E3CA428F-4F3B-4888-B916-2948C69800E8},-182.5,1835,246,13.4,127,74,58.3,1962,320,16.3
129,031507,13067031507,315.07,ARC 10,2015-05-21T18:32:35.000Z,{3AB3FF00-C62C-4D21-A87D-A488CA308966},-124.7,834,283,33.9,229,172,75.1,1063,455,42.8
130,031004,13067031004,310.04,ARC 10,2015-05-21T18:32:35.000Z,{B8DE8800-DA22-478A-B227-A87100C2B3EE},-449.4,1023,351,34.3,1343,816,60.8,2366,1167,49.3
131,030103,13067030103,301.03,ARC 10,2015-05-21T18:32:35.000Z,{63059C6D-16AF-4D81-A4AC-217D291CC129},498.9,2442,756,31,534,190,35.6,2976,946,31.8
132,031404,13067031404,314.04,ARC 10,2015-05-21T18:32:35.000Z,{CB4288F2-044D-42EE-91F0-5902FAFC74F9},117.9,1856,425,22.9,254,155,61,2110,580,27.5
133,031306,13067031306,313.06,ARC 10,2015-05-21T18:32:35.000Z,{896A6BFD-9E69-4A10-B5CC-8555B7ABE23F},107.7,1028,235,22.9,450,315,70,1478,550,37.2
134,030101,13067030101,301.01,ARC 10,2015-05-21T18:32:35.000Z,{EA329E47-3568-4651-BBD7-56B574036F63},100.7,2204,733,33.3,419,153,36.5,2623,886,33.8
135,030104,13067030104,301.04,ARC 10,2015-05-21T18:32:35.000Z,{89879997-C8A4-4C32-938C-A948959F853D},150.7,1068,299,28,344,200,58.1,1412,499,35.3
136,130613,13117130613,1306.13,ARC 20,2015-05-21T18:32:35.000Z,{8BF8FC2F-4C8E-406A-AA41-8D8CF21E1828},474.2,806,140,17.4,140,89,63.6,946,229,24.2
137,130408,13117130408,1304.08,ARC 20,2015-05-21T18:32:35.000Z,{A9441721-5E32-4DA2-AD35-EFB13FA69D46},320.7,936,225,24,332,173,52.1,1268,398,31.4
138,130612,13117130612,1306.12,ARC 20,2015-05-21T18:32:35.000Z,{855B1C11-5CCF-475B-8BB3-13CD1B34A490},734.3,1694,459,27.1,142,15,10.6,1836,474,25.8
139,130608,13117130608,1306.08,ARC 20,2015-05-21T18:32:35.000Z,{8EE5E3D2-7EBB-4285-9B1D-B7BDEC75BC70},972.4,1208,511,42.3,87,28,32.2,1295,539,41.6
140,130307,13117130307,1303.07,ARC 20,2015-05-21T18:32:35.000Z,{312C155A-A5F8-4D72-A25A-69ECC96100F3},246,902,253,28,65,49,75.4,967,302,31.2
141,130302,13117130302,1303.02,ARC 20,2015-05-21T18:32:35.000Z,{7E7FDD97-FD26-462D-B8C7-903BCCA2B2F2},482.6,1484,444,29.9,132,36,27.3,1616,480,29.7
142,130304,13117130304,1303.04,ARC 20,2015-05-21T18:32:35.000Z,{35F7A072-545C-4CAF-A71E-BF93381A1110},138.3,1112,207,18.6,131,74,56.5,1243,281,22.6
143,130404,13117130404,1304.04,ARC 20,2015-05-21T18:32:35.000Z,{950F0B58-D6E1-46A5-AA3D-02166390CC6C},1065.2,1148,358,31.2,161,34,21.1,1309,392,29.9
144,130306,13117130306,1303.06,ARC 20,2015-05-21T18:32:35.000Z,{264C80CB-6EF9-4EE5-A4FC-637F1BF2A61E},544.7,1201,466,38.8,28,0,0,1229,466,37.9
145,130601,13117130601,1306.01,ARC 20,2015-05-21T18:32:35.000Z,{E82212F5-1333-4515-84A2-CE77F873D3E3},281.9,1050,189,18,194,51,26.3,1244,240,19.3
146,130510,13117130510,1305.10,ARC 20,2015-05-21T18:32:35.000Z,{EA3DB94E-C12B-4F76-9FEB-D0BE429A271F},473.7,1404,222,15.8,534,171,32,1938,393,20.3
147,130406,13117130406,1304.06,ARC 20,2015-05-21T18:32:35.000Z,{CB26A01B-64DB-4116-AA5B-4DD8C8DFD7DB},1310,1374,357,26,228,176,77.2,1602,533,33.3
148,130410,13117130410,1304.10,ARC 20,2015-05-21T18:32:35.000Z,{34BDB4EC-D6E0-4599-852B-DCF5D1D06B72},703.1,768,205,26.7,794,454,57.2,1562,659,42.2
149,130203,13117130203,1302.03,ARC 20,2015-05-21T18:32:35.000Z,{35818D08-6315-455C-BDFE-EB336F3ABC41},91.5,1201,278,23.1,249,84,33.7,1450,362,25
150,130204,13117130204,1302.04,ARC 20,2015-05-21T18:32:35.000Z,{C1D47C28-F650-4351-8635-9A105C9E39B6},470,957,273,28.5,196,177,90.3,1153,450,39
151,130202,13117130202,1302.02,ARC 20,2015-05-21T18:32:35.000Z,{011DC382-9EBB-498E-B3BE-F31856F451F6},402.2,1205,248,20.6,59,33,55.9,1264,281,22.2
152,130509,13117130509,1305.09,ARC 20,2015-05-21T18:32:35.000Z,{9E6C646B-C03D-4520-9CAD-3B668D3F94C8},-2.4,818,269,32.9,163,59,36.2,981,328,33.4
153,130403,13117130403,1304.03,ARC 20,2015-05-21T18:32:35.000Z,{737066FB-5E60-4076-9379-0EFF3F201388},154.5,1775,500,28.2,112,23,20.5,1887,523,27.7
154,031506,13067031506,315.06,ARC 10,2015-05-21T18:32:35.000Z,{2951EB7A-691E-40DB-AC95-75D7968238E8},92.2,1309,318,24.3,384,211,54.9,1693,529,31.2
155,031508,13067031508,315.08,ARC 10,2015-05-21T18:32:35.000Z,{E09EA5A1-F2BA-4933-8B76-0299FFDC5836},257.7,1438,498,34.6,224,94,42,1662,592,35.6
156,031116,13067031116,311.16,ARC 10,2015-05-21T18:32:35.000Z,{972A5AD6-84E8-445D-B60B-EBC3700A8607},-264.5,706,164,23.2,726,523,72,1432,687,48
157,031115,13067031115,311.15,ARC 10,2015-05-21T18:32:35.000Z,{9DCCAC49-1E04-4ED5-B9A9-7F3AAA256731},425,1022,294,28.8,511,241,47.2,1533,535,34.9
158,030223,13067030223,302.23,ARC 10,2015-05-21T18:32:35.000Z,{EF933CF9-BDF6-46B6-A916-BA4246982519},661.2,1337,306,22.9,808,369,45.7,2145,675,31.5
159,031312,13067031312,313.12,ARC 10,2015-05-21T18:32:35.000Z,{C1A1C8DC-C0E3-4204-887D-55101DE74F5F},689.6,2796,1061,37.9,560,303,54.1,3356,1364,40.6
160,031313,13067031313,313.13,ARC 10,2015-05-21T18:32:35.000Z,{ACC7F10B-10E4-431C-9BD8-223870B16DAF},975,3034,537,17.7,623,377,60.5,3657,914,25
161,031309,13067031309,313.09,ARC 10,2015-05-21T18:32:35.000Z,{65E3FB5A-BED2-4F08-9C85-D6A7DDF1B3AB},307.1,2090,619,29.6,443,240,54.2,2533,859,33.9
162,130101,13117130101,1301.01,ARC 20,2015-05-21T18:32:35.000Z,{7949FDCB-DF78-4B12-841A-B973669ADDA6},148.6,1033,231,22.4,196,117,59.7,1229,348,28.3
163,130104,13117130104,1301.04,ARC 20,2015-05-21T18:32:35.000Z,{7D463A73-8F22-4A9F-904C-7605D31340D1},147.6,1281,363,28.3,89,9,10.1,1370,372,27.2
164,130506,13117130506,1305.06,ARC 20,2015-05-21T18:32:35.000Z,{326CA3F8-1E55-4013-96F4-C5D511DB1849},309,840,233,27.7,284,166,58.5,1124,399,35.5
165,031509,13067031509,315.09,ARC 10,2015-05-21T18:32:35.000Z,{7EF789FD-8324-441C-928A-816833E1EA58},435.1,2615,747,28.6,417,176,42.2,3032,923,30.4
166,031113,13067031113,311.13,ARC 10,2015-05-21T18:32:35.000Z,{838F65C7-EF6F-4DAD-B7C3-756E2E7D09D1},-757.5,19,5,26.3,468,235,50.2,487,240,49.3
167,031114,13067031114,311.14,ARC 10,2015-05-21T18:32:35.000Z,{7EE6C0AF-2A70-4B3E-AF6A-7547884BDD3F},1146.4,532,160,30.1,3033,1329,43.8,3565,1489,41.8
168,030345,13067030345,303.45,ARC 10,2015-05-21T18:32:35.000Z,{BFE74F81-DCD7-4EE7-9165-93199B3EB0B7},491.8,250,136,54.4,1942,703,36.2,2192,839,38.3
169,030344,13067030344,303.44,ARC 10,2015-05-21T18:32:35.000Z,{9BDB36E3-0145-4926-AB23-6B092B88FC4B},-662.2,192,61,31.8,1484,619,41.7,1676,680,40.6
170,030411,13067030411,304.11,ARC 10,2015-05-21T18:32:35.000Z,{6D334F20-3E2E-4938-BC0C-F3D4EA0BBBAB},-593.8,133,70,52.6,1395,772,55.3,1528,842,55.1
171,030412,13067030412,304.12,ARC 10,2015-05-21T18:32:35.000Z,{C6BDBC50-C326-490F-BC97-49DE6FE4343A},-1303.8,222,121,54.5,1186,624,52.6,1408,745,52.9
172,030414,13067030414,304.14,ARC 10,2015-05-21T18:32:35.000Z,{7251D83C-1B58-491C-A4A6-38BBD72F8916},-659,0,0,,1060,597,56.3,1060,597,56.3
173,030413,13067030413,304.13,ARC 10,2015-05-21T18:32:35.000Z,{8270CD95-EFD4-4357-A412-15D1AC4994F3},-1313.3,278,64,23,1835,889,48.4,2113,953,45.1
174,030239,13067030239,302.39,ARC 10,2015-05-21T18:32:35.000Z,{0F9173A9-8779-412A-BE62-4E9CCD49EA91},228.4,2361,693,29.4,87,11,12.6,2448,704,28.8
175,030238,13067030238,302.38,ARC 10,2015-05-21T18:32:35.000Z,{9ECE44E2-EFB2-4DAA-884A-1927EAF42818},350.9,2042,482,23.6,81,81,100,2123,563,26.5
176,030236,13067030236,302.36,ARC 10,2015-05-21T18:32:35.000Z,{A1634A91-468A-4B17-8384-6B45D3353246},370.5,1335,362,27.1,45,31,68.9,1380,393,28.5
177,030407,13067030407,304.07,ARC 10,2015-05-21T18:32:35.000Z,{2497FD8A-BFF7-47F2-A6E0-5E0F9849032A},-70.6,1607,332,20.7,347,163,47,1954,495,25.3
178,030408,13067030408,304.08,ARC 10,2015-05-21T18:32:35.000Z,{6987D2F6-0289-4E1D-908A-77664343E499},7.8,780,155,19.9,437,198,45.3,1217,353,29
179,030410,13067030410,304.10,ARC 10,2015-05-21T18:32:35.000Z,{74AD16C3-0E75-4E34-A33E-6C19BE31E5E8},-34.1,809,141,17.4,1435,829,57.8,2244,970,43.2
180,030409,13067030409,304.09,ARC 10,2015-05-21T18:32:35.000Z,{1C605C66-56D9-4CF7-B9B5-6A679AE64B3C},198.6,1084,258,23.8,123,55,44.7,1207,313,25.9
181,030343,13067030343,303.43,ARC 10,2015-05-21T18:32:35.000Z,{33737AEB-B5F4-44F3-B1AA-DDE6B7755488},71.7,1548,356,23,35,9,25.7,1583,365,23.1
182,030342,13067030342,303.42,ARC 10,2015-05-21T18:32:35.000Z,{D6BB2FC8-946C-4620-9D24-03AA2C4E9125},62.1,1526,412,27,113,39,34.5,1639,451,27.5
183,030340,13067030340,303.40,ARC 10,2015-05-21T18:32:35.000Z,{B1F8AEBC-1BDF-4361-8CD6-CE4DD8D31E6F},-179.4,1171,169,14.4,107,0,0,1278,169,13.2
184,030341,13067030341,303.41,ARC 10,2015-05-21T18:32:35.000Z,{5D30179F-7630-47AD-AA9F-B06973E2E352},30.6,1400,314,22.4,126,68,54,1526,382,25
185,031409,13067031409,314.09,ARC 10,2015-05-21T18:32:35.000Z,{15427837-09E9-4E40-ADAA-50ECFD825F88},14,1443,672,46.6,421,284,67.5,1864,956,51.3
186,031408,13067031408,314.08,ARC 10,2015-05-21T18:32:35.000Z,{43B9C788-8320-433F-AC29-F5AFA61E17D1},211.3,1365,344,25.2,618,470,76.1,1983,814,41
187,030107,13067030107,301.07,ARC 10,2015-05-21T18:32:35.000Z,{61EEFFC0-770A-421D-B712-1C793B712230},725.6,1368,414,30.3,230,78,33.9,1598,492,30.8
188,030106,13067030106,301.06,ARC 10,2015-05-21T18:32:35.000Z,{ED0BCDCE-6929-4426-8968-953101A72AD5},1167.9,1418,589,41.5,1099,567,51.6,2517,1156,45.9
189,030505,13067030505,305.05,ARC 10,2015-05-21T18:32:35.000Z,{31F246B8-68A0-4EC2-A485-C618830FAD44},395.5,505,119,23.6,2256,1350,59.8,2761,1469,53.2
190,030800,13067030800,308,ARC 10,2015-05-21T18:32:35.000Z,{DACE11E3-2686-42FB-B2AB-F34C44EECA7B},-498,446,147,33,1003,597,59.5,1449,744,51.3
191,030902,13067030902,309.02,ARC 10,2015-05-21T18:32:35.000Z,{D789B4CD-6B9D-4234-B873-43D84200D245},-704.5,1023,287,28.1,1132,528,46.6,2155,815,37.8
192,031311,13067031311,313.11,ARC 10,2015-05-21T18:32:35.000Z,{49751596-EFC0-4530-B868-538B09FF3EBD},592.5,1386,486,35.1,1883,1156,61.4,3269,1642,50.2
193,031406,13067031406,314.06,ARC 10,2015-05-21T18:32:35.000Z,{6EF07ED2-EDF6-4C55-885E-766863D45075},892.1,1055,275,26.1,1691,928,54.9,2746,1203,43.8
194,031405,13067031405,314.05,ARC 10,2015-05-21T18:32:35.000Z,{23245A51-6BF7-446C-ACDE-7831BE709042},5.1,2207,669,30.3,678,413,60.9,2885,1082,37.5
195,030320,13067030320,303.20,ARC 10,2015-05-21T18:32:35.000Z,{AD4ACEE7-7B63-4924-B174-C3EC7F15EC01},357.5,2089,617,29.5,1297,531,40.9,3386,1148,33.9
196,030318,13067030318,303.18,ARC 10,2015-05-21T18:32:35.000Z,{FCFAC6AB-6B8D-47D0-8413-E579C87092DF},67.4,2586,776,30,170,127,74.7,2756,903,32.8
197,031005,13067031005,310.05,ARC 10,2015-05-21T18:32:35.000Z,{412A6F89-B910-4B99-B2E4-37F14F8CA216},445,1267,509,40.2,321,116,36.1,1588,625,39.4
198,031002,13067031002,310.02,ARC 10,2015-05-21T18:32:35.000Z,{0727C682-CFC3-4A0D-BC0F-9BEE596BC4D2},579.4,786,254,32.3,2084,1288,61.8,2870,1542,53.7
199,030904,13067030904,309.04,ARC 10,2015-05-21T18:32:35.000Z,{96A7570A-30F5-4723-8826-8EC1522AC69C},-38.5,980,384,39.2,1190,747,62.8,2170,1131,52.1
200,030901,13067030901,309.01,ARC 10,2015-05-21T18:32:35.000Z,{3339C57B-AA7C-4037-AE34-829C11BAB2C2},-19.3,2361,677,28.7,798,618,77.4,3159,1295,41
201,031503,13067031503,315.03,ARC 10,2015-05-21T18:32:35.000Z,{83A63566-7771-480A-81B4-25BE3FDC5A8D},78.4,2160,675,31.3,543,389,71.6,2703,1064,39.4
202,031307,13067031307,313.07,ARC 10,2015-05-21T18:32:35.000Z,{6D21B008-4A18-4363-BCA4-831E8F267CFE},28.5,1676,404,24.1,394,124,31.5,2070,528,25.5
203,031308,13067031308,313.08,ARC 10,2015-05-21T18:32:35.000Z,{79926BED-7523-47BC-BB34-C881CB9F55D5},114.8,1073,320,29.8,602,430,71.4,1675,750,44.8
204,030319,13067030319,303.19,ARC 10,2015-05-21T18:32:36.000Z,{97AA630F-98CE-4193-B5C0-72D2B16B65CF},-9.3,1470,449,30.5,104,48,46.2,1574,497,31.6
205,030333,13067030333,303.33,ARC 10,2015-05-21T18:32:36.000Z,{57A87DF8-2779-4D00-AA3F-BAFF36E069EF},28.3,1954,376,19.2,175,57,32.6,2129,433,20.3
206,030332,13067030332,303.32,ARC 10,2015-05-21T18:32:36.000Z,{CDF8BF8B-48CD-4909-979E-B552C4D720AB},-35.7,1051,220,20.9,97,55,56.7,1148,275,24
207,030335,13067030335,303.35,ARC 10,2015-05-21T18:32:36.000Z,{5BC687E7-6772-4E5A-857B-C7C7FC968DC3},-173,1507,297,19.7,84,55,65.5,1591,352,22.1
208,031106,13067031106,311.06,ARC 10,2015-05-21T18:32:36.000Z,{86652304-408C-4C8A-AEDB-211E652B957D},258.6,2138,539,25.2,665,353,53.1,2803,892,31.8
209,030331,13067030331,303.31,ARC 10,2015-05-21T18:32:36.000Z,{A2320A25-4CD1-48AD-BA80-598BC168F699},-73.6,1873,461,24.6,81,48,59.3,1954,509,26
210,030322,13067030322,303.22,ARC 10,2015-05-21T18:32:36.000Z,{03DE87D6-ADB4-4314-91BF-FD41047EAADB},-15.7,1013,216,21.3,102,50,49,1115,266,23.9
211,031112,13067031112,311.12,ARC 10,2015-05-21T18:32:36.000Z,{5AE58C52-2A1F-4B6F-8E53-5CF7FFC57922},10,1429,327,22.9,670,402,60,2099,729,34.7
212,030504,13067030504,305.04,ARC 10,2015-05-21T18:32:36.000Z,{34C19204-B3FF-4789-89BB-8FD068AEE7A5},189.2,1861,542,29.1,502,329,65.5,2363,871,36.9
213,030327,13067030327,303.27,ARC 10,2015-05-21T18:32:36.000Z,{818A9F0A-E652-4F5A-BCA2-10117A788108},18.4,1282,274,21.4,176,57,32.4,1458,331,22.7
214,030329,13067030329,303.29,ARC 10,2015-05-21T18:32:36.000Z,{8C3C6B3C-FD31-477B-AFB4-736F4FEEE65D},-97.6,1454,248,17.1,209,63,30.1,1663,311,18.7
215,030339,13067030339,303.39,ARC 10,2015-05-21T18:32:36.000Z,{135B152C-D894-4D39-A425-CB24951D524A},607.2,453,131,28.9,2476,837,33.8,2929,968,33
216,030314,13067030314,303.14,ARC 10,2015-05-21T18:32:36.000Z,{A06CA44F-D3E3-4D2C-83A2-46FF0622C332},271.6,2290,629,27.5,177,125,70.6,2467,754,30.6
217,030336,13067030336,303.36,ARC 10,2015-05-21T18:32:36.000Z,{92443511-6110-4579-9FCB-D3DCB3C8F1A7},-159.3,2332,597,25.6,147,88,59.9,2479,685,27.6
218,040411,13063040411,404.11,ARC 10,2015-05-21T18:32:36.000Z,{C88903C3-AD9F-4CA7-8C9B-2B5438BC9E1F},679.1,3166,973,30.7,547,444,81.2,3713,1417,38.2
219,040512,13063040512,405.12,ARC 10,2015-05-21T18:32:36.000Z,{8ACD08C0-4CB7-40EA-A0DE-F161E501BB0C},360,865,275,31.8,829,561,67.7,1694,836,49.4
220,040608,13063040608,406.08,ARC 10,2015-05-21T18:32:36.000Z,{AA61D74F-775B-473C-9ECC-79A6EE1A464D},339.3,2644,833,31.5,855,527,61.6,3499,1360,38.9
221,040614,13063040614,406.14,ARC 10,2015-05-21T18:32:36.000Z,{7E51487F-2522-4775-AD7E-6CC162CA994B},-135.2,1395,340,24.4,406,233,57.4,1801,573,31.8
222,040606,13063040606,406.06,ARC 10,2015-05-21T18:32:36.000Z,{977237DC-FF39-4C8B-BD9E-4864EE55EBF0},22.7,667,267,40,271,237,87.5,938,504,53.7
223,040612,13063040612,406.12,ARC 10,2015-05-21T18:32:36.000Z,{D63A3BBD-F0F5-4D3D-B8A5-3AEB61FB24D2},969.3,942,446,47.3,780,448,57.4,1722,894,51.9
224,040609,13063040609,406.09,ARC 10,2015-05-21T18:32:36.000Z,{F9B79CFB-EABB-4CA6-9955-C5C137040DE1},362.2,1346,335,24.9,843,368,43.7,2189,703,32.1
225,040412,13063040412,404.12,ARC 10,2015-05-21T18:32:36.000Z,{8E29801B-ECE2-4C01-B5C0-8BFF74EFA563},142.9,1378,485,35.2,1322,616,46.6,2700,1101,40.8
226,040413,13063040413,404.13,ARC 10,2015-05-21T18:32:36.000Z,{6B32A5A5-9F7F-4F0A-BCD8-B16355FBD88B},569.5,1737,619,35.6,745,544,73,2482,1163,46.9
227,040613,13063040613,406.13,ARC 10,2015-05-21T18:32:36.000Z,{EC2438B3-DCD0-4C39-9DA8-7C2D2E3851D2},264.7,1921,855,44.5,560,406,72.5,2481,1261,50.8
228,040408,13063040408,404.08,ARC 10,2015-05-21T18:32:36.000Z,{9A270D2D-933B-4286-B334-C6152BEB03DA},80.8,978,277,28.3,1467,640,43.6,2445,917,37.5
229,040409,13063040409,404.09,ARC 10,2015-05-21T18:32:36.000Z,{A985A988-70A1-4469-925A-5776E9B394BE},170,1112,327,29.4,567,364,64.2,1679,691,41.2
230,040410,13063040410,404.10,ARC 10,2015-05-21T18:32:36.000Z,{3C6473BD-BC8D-46F1-9946-686F78E6C8F9},150.5,1596,885,55.5,583,457,78.4,2179,1342,61.6
231,040303,13063040303,403.03,ARC 10,2015-05-21T18:32:36.000Z,{C8E1A8FB-288A-44C3-B6DB-C9C1562F1DBF},-348.3,1110,353,31.8,685,534,78,1795,887,49.4
232,040302,13063040302,403.02,ARC 10,2015-05-21T18:32:36.000Z,{0ED13A6D-29DE-48CA-BA03-37FF9077D38D},-646.8,598,208,34.8,857,498,58.1,1455,706,48.5
233,040611,13063040611,406.11,ARC 10,2015-05-21T18:32:36.000Z,{A6018638-6B15-400C-8BB7-6AE452E886E6},155,783,297,37.9,1356,696,51.3,2139,993,46.4
234,040407,13063040407,404.07,ARC 10,2015-05-21T18:32:36.000Z,{FD097147-57C8-4B7C-A22F-BAD5BAEB7A17},94,719,246,34.2,343,180,52.5,1062,426,40.1
235,040510,13063040510,405.10,ARC 10,2015-05-21T18:32:36.000Z,{8E6D4FA7-DD81-48DD-96BB-30175872A893},-286.7,560,247,44.1,418,232,55.5,978,479,49
236,040514,13063040514,405.14,ARC 10,2015-05-21T18:32:36.000Z,{C1ADA4AC-29DB-4383-A041-4FC19E63AEF4},988.4,1276,481,37.7,1331,996,74.8,2607,1477,56.7
237,040307,13063040307,403.07,ARC 10,2015-05-21T18:32:36.000Z,{3D9B4014-F0E0-49DD-9134-EF7A18CA9A10},495,1080,532,49.3,256,202,78.9,1336,734,54.9
238,980000,13063980000,9800,ARC 10,2015-05-21T18:32:36.000Z,{BB6E56A8-EE2C-4DCC-92B5-C9E8D6E064E6},,0,0,,0,0,,0,0,
239,040622,13063040622,406.22,ARC 10,2015-05-21T18:32:36.000Z,{9AB07B64-4E8B-4A19-85B3-BF0D8A2947AD},-87.8,1681,685,40.7,558,399,71.5,2239,1084,48.4
240,040621,13063040621,406.21,ARC 10,2015-05-21T18:32:36.000Z,{B4C95C8E-44C1-46B9-9022-33E4CF16EFB8},1229,2002,657,32.8,567,242,42.7,2569,899,35
241,040619,13063040619,406.19,ARC 10,2015-05-21T18:32:36.000Z,{6292BDF4-32D9-4687-B036-EFB1905A519B},142.9,602,286,47.5,366,229,62.6,968,515,53.2
242,040523,13063040523,405.23,ARC 10,2015-05-21T18:32:36.000Z,{EB452969-8651-460E-A13D-1112F23744CA},978,553,131,23.7,382,252,66,935,383,41
243,040522,13063040522,405.22,ARC 10,2015-05-21T18:32:36.000Z,{DA4AD94B-190F-4658-B8A8-7EFAEC1267D1},-504.7,675,375,55.6,877,536,61.1,1552,911,58.7
244,040520,13063040520,405.20,ARC 10,2015-05-21T18:32:36.000Z,{896A8883-DA09-45FA-8F10-E67B4659A6B5},-523.8,275,109,39.6,1183,682,57.7,1458,791,54.3
245,040519,13063040519,405.19,ARC 10,2015-05-21T18:32:36.000Z,{1B7A9A43-CAB5-46F8-ABDB-1A8B673162A5},1263.3,0,0,,1812,1092,60.3,1812,1092,60.3
246,040417,13063040417,404.17,ARC 10,2015-05-21T18:32:36.000Z,{48AEA8F4-C48F-44BE-9F2D-336FE34CE091},12.5,324,127,39.2,1265,883,69.8,1589,1010,63.6
247,040203,13063040203,402.03,ARC 10,2015-05-21T18:32:36.000Z,{A9682AC0-2F09-4FE5-B06D-7216BFE4AB86},117.3,363,85,23.4,850,528,62.1,1213,613,50.5
248,040617,13063040617,406.17,ARC 10,2015-05-21T18:32:36.000Z,{6512B442-12E1-4B78-A6A6-5F66646634CF},520,302,101,33.4,95,36,37.9,397,137,34.5
249,040615,13063040615,406.15,ARC 10,2015-05-21T18:32:36.000Z,{1A653A4B-0A7D-49F6-AE6F-FEA10B3F2486},138.5,491,203,41.3,123,87,70.7,614,290,47.2
250,040521,13063040521,405.21,ARC 10,2015-05-21T18:32:36.000Z,{21B6AE0F-66EB-4E50-A10D-EEFAC6DB75B3},-113,643,163,25.3,344,182,52.9,987,345,35
251,040415,13063040415,404.15,ARC 10,2015-05-21T18:32:36.000Z,{2CF43A1E-A897-4BD2-9C86-A87ACF9EAC01},-703.1,435,112,25.7,1326,886,66.8,1761,998,56.7
252,040414,13063040414,404.14,ARC 10,2015-05-21T18:32:36.000Z,{B32F2F30-3D23-4DD3-A6C9-BBEEF007F188},403.8,340,165,48.5,212,77,36.3,552,242,43.8
253,040204,13063040204,402.04,ARC 10,2015-05-21T18:32:36.000Z,{3A9A4672-EC99-4267-982B-9BA394A5FF4E},-625.5,442,116,26.2,968,517,53.4,1410,633,44.9
254,040308,13063040308,403.08,ARC 10,2015-05-21T18:32:36.000Z,{0635FBB0-D87D-46C7-ADF7-CD4E2DACAC12},-215.3,595,121,20.3,852,573,67.3,1447,694,48
255,040620,13063040620,406.20,ARC 10,2015-05-21T18:32:36.000Z,{D1A07D45-1215-4C4B-952F-D2D73585DE18},366.3,912,377,41.3,30,16,53.3,942,393,41.7
256,040616,13063040616,406.16,ARC 10,2015-05-21T18:32:36.000Z,{135006A3-B90C-41A6-A004-2B80B7CB37F9},613.8,831,249,30,1943,1009,51.9,2774,1258,45.3
257,040526,13063040526,405.26,ARC 10,2015-05-21T18:32:36.000Z,{A703297D-1EF1-49EF-81B2-250F24527315},-89.5,1088,404,37.1,701,422,60.2,1789,826,46.2
258,040525,13063040525,405.25,ARC 10,2015-05-21T18:32:36.000Z,{C3F05BDA-BDE8-4880-990E-919FCA5904A7},-22.2,723,397,54.9,203,114,56.2,926,511,55.2
259,040524,13063040524,405.24,ARC 10,2015-05-21T18:32:36.000Z,{833553AA-E755-423F-A65D-FB097D25025E},-362.9,1355,476,35.1,1117,490,43.9,2472,966,39.1
260,040416,13063040416,404.16,ARC 10,2015-05-21T18:32:36.000Z,{B7AB0E85-2386-4E34-BE50-0BFB0B301F20},-444.7,657,276,42,398,274,68.8,1055,550,52.1
261,040306,13063040306,403.06,ARC 10,2015-05-21T18:32:36.000Z,{3E5426DB-B5C9-402C-965F-87119E3ACB11},-125.9,99,18,18.2,1062,727,68.5,1161,745,64.2
262,040516,13063040516,405.16,ARC 10,2015-05-21T18:32:36.000Z,{4D5AAC56-0C4D-43DA-9359-6B8516CFBF31},755.3,1403,727,51.8,545,483,88.6,1948,1210,62.1
263,040509,13063040509,405.09,ARC 10,2015-05-21T18:32:36.000Z,{748DB3E7-CE4D-4B13-B6B9-9FABCF631FBB},-9,1027,234,22.8,419,160,38.2,1446,394,27.2
264,040202,13063040202,402.02,ARC 10,2015-05-21T18:32:36.000Z,{E4DA41C6-2E65-4FA0-9BF5-F6C415FEEC35},-415.1,169,36,21.3,616,411,66.7,785,447,56.9
265,040518,13063040518,405.18,ARC 10,2015-05-21T18:32:36.000Z,{4987A61F-37B0-421F-9B0C-8D123035DAF0},344.3,720,291,40.4,801,501,62.5,1521,792,52.1
266,040515,13063040515,405.15,ARC 10,2015-05-21T18:32:36.000Z,{7537F5D9-81DE-4B5C-A6E2-5310CCCE297E},-111.7,1207,355,29.4,1112,661,59.4,2319,1016,43.8
267,040513,13063040513,405.13,ARC 10,2015-05-21T18:32:36.000Z,{0A880CE4-35DF-4198-AF1D-5D4B577E6A10},-77.8,1129,369,32.7,290,140,48.3,1419,509,35.9
268,070403,13151070403,704.03,ARC 10,2015-05-21T18:32:36.000Z,{C21E3393-30EE-4741-8C7D-AA33F60E0ABA},204,2862,973,34,497,188,37.8,3359,1161,34.6
269,070307,13151070307,703.07,ARC 10,2015-05-21T18:32:36.000Z,{59908E63-2B2F-4889-917E-9D4181BE515F},624.1,1337,318,23.8,200,151,75.5,1537,469,30.5
270,070113,13151070113,701.13,ARC 10,2015-05-21T18:32:36.000Z,{44A8109C-7F5C-4DDE-B7BB-321C141C73A6},6.9,947,327,34.5,449,231,51.4,1396,558,40
271,070501,13151070501,705.01,ARC 10,2015-05-21T18:32:36.000Z,{AEA38434-1696-4346-B21B-08DE6729A399},150.7,1467,472,32.2,622,542,87.1,2089,1014,48.5
272,070502,13151070502,705.02,ARC 10,2015-05-21T18:32:36.000Z,{49E92FB3-CBE9-4FD2-9EEA-236630EA5E73},270.4,4054,985,24.3,512,386,75.4,4566,1371,30
273,070311,13151070311,703.11,ARC 10,2015-05-21T18:32:36.000Z,{DAED0CC5-B158-4E66-B161-A91066EE960D},1014.1,1703,520,30.5,2389,1096,45.9,4092,1616,39.5
274,070404,13151070404,704.04,ARC 10,2015-05-21T18:32:36.000Z,{6271FE3B-F4BC-4CBB-81A0-172A6773E185},165.4,1687,443,26.3,648,345,53.2,2335,788,33.7
275,070204,13151070204,702.04,ARC 10,2015-05-21T18:32:36.000Z,{1539A167-3C65-4431-8A92-4361C0A3971C},81.3,1358,374,27.5,131,95,72.5,1489,469,31.5
276,070310,13151070310,703.10,ARC 10,2015-05-21T18:32:36.000Z,{DA5B5FB1-755A-4037-8C3F-CBFC886426EF},-157.9,1155,355,30.7,275,121,44,1430,476,33.3
277,070205,13151070205,702.05,ARC 10,2015-05-21T18:32:36.000Z,{568AD423-CFCD-47A8-9AEA-456B2B26C4C1},342.1,2388,676,28.3,935,404,43.2,3323,1080,32.5
278,070309,13151070309,703.09,ARC 10,2015-05-21T18:32:36.000Z,{DFC5C3D3-CA0D-4F97-B667-072153DA6A5B},792,1903,549,28.8,319,97,30.4,2222,646,29.1
279,070114,13151070114,701.14,ARC 10,2015-05-21T18:32:36.000Z,{79350E29-83B2-4973-AFA4-B8E756EEF467},437.7,699,314,44.9,1349,561,41.6,2048,875,42.7
280,070111,13151070111,701.11,ARC 10,2015-05-21T18:32:36.000Z,{E2035EFF-66E3-4CB6-BA72-A0A9975102DC},578.6,1836,683,37.2,1064,598,56.2,2900,1281,44.2
281,070107,13151070107,701.07,ARC 10,2015-05-21T18:32:36.000Z,{FCCCB191-E7D4-4BAA-8B4D-6CB221892E58},136.8,1885,756,40.1,215,75,34.9,2100,831,39.6
282,070109,13151070109,701.09,ARC 10,2015-05-21T18:32:36.000Z,{5CB659B6-0B47-4BBF-BFCC-685594142CFC},102.7,1002,325,32.4,76,31,40.8,1078,356,33
283,070110,13151070110,701.10,ARC 10,2015-05-21T18:32:36.000Z,{A4EFABD9-1848-4824-AC1E-FE3C505819C7},108.4,2076,706,34,431,165,38.3,2507,871,34.7
284,070108,13151070108,701.08,ARC 10,2015-05-21T18:32:36.000Z,{A2DD02E5-1A07-4BEB-B5E2-31BB160359CB},337.6,1367,461,33.7,237,58,24.5,1604,519,32.4
285,070306,13151070306,703.06,ARC 10,2015-05-21T18:32:36.000Z,{58DB397C-401D-4C99-9A68-25BA668853D1},461.8,2106,675,32.1,1147,453,39.5,3253,1128,34.7
286,070104,13151070104,701.04,ARC 10,2015-05-21T18:32:36.000Z,{76EFCAD2-B3DE-4584-9700-8CB65FCEF00E},718.3,2914,1092,37.5,1054,641,60.8,3968,1733,43.7
287,070202,13151070202,702.02,ARC 10,2015-05-21T18:32:36.000Z,{60E6F5DA-F464-4055-BC7A-A183EE253E7C},256.4,3158,855,27.1,223,17,7.6,3381,872,25.8
288,070305,13151070305,703.05,ARC 10,2015-05-21T18:32:36.000Z,{85D98272-EA0B-4EA6-8FD7-12F166A7BD6D},180.5,2547,856,33.6,247,112,45.3,2794,968,34.6
289,070304,13151070304,703.04,ARC 10,2015-05-21T18:32:36.000Z,{81625B77-1729-497C-97BC-D2FF3915D26D},533.3,1987,862,43.4,1781,1166,65.5,3768,2028,53.8
290,070106,13151070106,701.06,ARC 10,2015-05-21T18:32:36.000Z,{D6357253-37F2-4B50-B797-81C9E4526A4E},120,1384,405,29.3,463,277,59.8,1847,682,36.9
291,070203,13151070203,702.03,ARC 10,2015-05-21T18:32:36.000Z,{54575D04-8B30-48FE-813F-7402C95219A7},223.8,4239,1191,28.1,526,296,56.3,4765,1487,31.2
292,070402,13151070402,704.02,ARC 10,2015-05-21T18:32:36.000Z,{EE271EB5-6AE0-42C0-AE2D-C7D6FCD87E5D},158.9,3211,958,29.8,472,257,54.4,3683,1215,33
293,960101,13015960101,9601.01,ARC 20,2015-05-21T18:32:36.000Z,{ADD67004-0A26-4CF1-87EE-EB7185AEF154},12.2,515,130,25.2,68,23,33.8,583,153,26.2
294,960402,13015960402,9604.02,ARC 20,2015-05-21T18:32:36.000Z,{3D3616B9-4188-473B-A744-87BEFD432567},154.4,1853,550,29.7,1101,602,54.7,2954,1152,39
295,960901,13015960901,9609.01,ARC 20,2015-05-21T18:32:36.000Z,{9ECE20A8-C623-485A-91EE-02B172852A4B},6,607,157,25.9,354,125,35.3,961,282,29.3
296,960102,13015960102,9601.02,ARC 20,2015-05-21T18:32:36.000Z,{C88B857B-A11F-4786-A56B-FA726CD2257C},24.6,2575,751,29.2,591,219,37.1,3166,970,30.6
297,960802,13015960802,9608.02,ARC 20,2015-05-21T18:32:36.000Z,{74785B43-3888-4000-8AB3-91ADC578989E},57.9,751,248,33,212,124,58.5,963,372,38.6
298,961000,13015961000,9610,ARC 20,2015-05-21T18:32:36.000Z,{159F5F90-E685-4518-8610-CB4C659CB50D},31.8,2305,614,26.6,235,120,51.1,2540,734,28.9
299,960801,13015960801,9608.01,ARC 20,2015-05-21T18:32:36.000Z,{9584E6C2-A3F3-4701-AB37-03B33759F38B},43.9,954,356,37.3,231,153,66.2,1185,509,43
300,960300,13015960300,9603,ARC 20,2015-05-21T18:32:36.000Z,{6D6D744A-4F9C-4F53-B453-79210B3AB122},41.6,1974,493,25,216,123,56.9,2190,616,28.1
301,960902,13015960902,9609.02,ARC 20,2015-05-21T18:32:36.000Z,{82CCDEA8-086D-441B-BD7D-548525E78606},78,1809,409,22.6,300,169,56.3,2109,578,27.4
302,960500,13015960500,9605,ARC 20,2015-05-21T18:32:36.000Z,{9DA614A7-069C-4D44-9155-3701E30A5A76},231.2,1430,318,22.2,1163,508,43.7,2593,826,31.9
303,960600,13015960600,9606,ARC 20,2015-05-21T18:32:36.000Z,{7A95E619-26F1-4D47-B14C-186DCB55B24B},140.7,1662,444,26.7,1316,935,71,2978,1379,46.3
304,960200,13015960200,9602,ARC 20,2015-05-21T18:32:36.000Z,{FD62E06F-5071-4EFF-ADDF-FFCEC34C1712},44.7,2814,594,21.1,957,431,45,3771,1025,27.2
305,960401,13015960401,9604.01,ARC 20,2015-05-21T18:32:36.000Z,{A5C6A2B2-2482-49DD-AC81-394B76DFB31D},425.7,1571,458,29.2,1433,874,61,3004,1332,44.3
306,960803,13015960803,9608.03,ARC 20,2015-05-21T18:32:36.000Z,{98C6C9B0-A9DD-42A9-A6C5-5D1015B5F17C},22.8,1336,420,31.4,593,300,50.6,1929,720,37.3
307,960700,13015960700,9607,ARC 20,2015-05-21T18:32:36.000Z,{EEE9D10F-3AFE-4981-B5F4-9A9C930CBC61},53.3,956,317,33.2,1357,691,50.9,2313,1008,43.6
308,050319,13135050319,503.19,ARC 10,2015-05-21T18:32:36.000Z,{E2F1CC95-4635-4698-9530-D1A9C75F3E3E},-660,593,137,23.1,1023,641,62.7,1616,778,48.1
309,050219,13135050219,502.19,ARC 10,2015-05-21T18:32:36.000Z,{3083EE17-2570-43C8-8BA8-9EAF85811076},-331.8,1052,248,23.6,344,76,22.1,1396,324,23.2
310,050211,13135050211,502.11,ARC 10,2015-05-21T18:32:36.000Z,{66974160-47A2-415F-9C04-5ADCB32601D5},-947.7,361,189,52.4,1546,1019,65.9,1907,1208,63.3
311,050215,13135050215,502.15,ARC 10,2015-05-21T18:32:36.000Z,{DE89556F-B52A-4C9F-9CE6-54721518957E},444.6,309,203,65.7,879,362,41.2,1188,565,47.6
312,050216,13135050216,502.16,ARC 10,2015-05-21T18:32:36.000Z,{61B4769D-6C06-418D-B840-6FADEB33AF4D},637.8,2042,671,32.9,519,115,22.2,2561,786,30.7
313,050527,13135050527,505.27,ARC 10,2015-05-21T18:32:36.000Z,{C6CEC756-A416-43CD-926C-BD986B03A3EA},76.5,1666,424,25.5,225,165,73.3,1891,589,31.1
314,050549,13135050549,505.49,ARC 10,2015-05-21T18:32:36.000Z,{4F43D5ED-63C3-4774-8614-A645650A88C3},235.3,1316,388,29.5,178,75,42.1,1494,463,31
315,050540,13135050540,505.40,ARC 10,2015-05-21T18:32:36.000Z,{5AC61BFA-F51E-41F1-8BE0-5FE60AA1CC99},544.1,984,334,33.9,1434,690,48.1,2418,1024,42.3
316,050722,13135050722,507.22,ARC 10,2015-05-21T18:32:36.000Z,{D5485E43-2F2C-4278-9D57-43B537BB5F49},422.9,822,373,45.4,185,90,48.6,1007,463,46
317,050729,13135050729,507.29,ARC 10,2015-05-21T18:32:36.000Z,{B8D0E4F7-49E5-4412-8E57-7A5C6BC85C74},222,723,369,51,513,260,50.7,1236,629,50.9
318,050725,13135050725,507.25,ARC 10,2015-05-21T18:32:36.000Z,{29D23138-5FEF-4D6A-94A6-7CC6323ECACF},280,1524,539,35.4,190,74,38.9,1714,613,35.8
319,050730,13135050730,507.30,ARC 10,2015-05-21T18:32:36.000Z,{1C295F31-B48C-4ED2-8C72-207A9A38B0A9},613.3,1771,408,23,375,155,41.3,2146,563,26.2
320,050728,13135050728,507.28,ARC 10,2015-05-21T18:32:36.000Z,{1AF98B55-3BAA-4C91-A2C6-9635F1CDFFB4},629.2,3783,1333,35.2,485,381,78.6,4268,1714,40.2
321,050731,13135050731,507.31,ARC 10,2015-05-21T18:32:36.000Z,{20E8B715-A003-4A84-A7C1-C6B6AD2B67EF},753.9,2615,847,32.4,221,111,50.2,2836,958,33.8
322,050609,13135050609,506.09,ARC 10,2015-05-21T18:32:36.000Z,{EA7BFF71-3EAB-4F82-ACA9-E6E7D6315879},591.4,2970,959,32.3,379,74,19.5,3349,1033,30.8
323,050610,13135050610,506.10,ARC 10,2015-05-21T18:32:36.000Z,{5FF6F981-5814-4D99-9683-7A1C9453FD62},593.4,4269,1407,33,433,186,43,4702,1593,33.9
324,050541,13135050541,505.41,ARC 10,2015-05-21T18:32:36.000Z,{E11D7BB9-F257-4656-88B2-8C60C24DA92E},442,68,28,41.2,1998,1021,51.1,2066,1049,50.8
325,050524,13135050524,505.24,ARC 10,2015-05-21T18:32:36.000Z,{F9BBF6E5-CFC2-4B98-AEEC-F31DD2AF2034},348.5,941,283,30.1,910,609,66.9,1851,892,48.2
326,050547,13135050547,505.47,ARC 10,2015-05-21T18:32:36.000Z,{7B5A6E42-094C-4946-8460-297BA1AEE0EC},323.3,1897,531,28,326,259,79.4,2223,790,35.5
327,050523,13135050523,505.23,ARC 10,2015-05-21T18:32:36.000Z,{A2F418C3-75A9-406C-B015-D95BB9A2D05B},691,805,203,25.2,1978,1033,52.2,2783,1236,44.4
328,050724,13135050724,507.24,ARC 10,2015-05-21T18:32:36.000Z,{3C1A6B8A-8961-4B4F-95F7-EE6C9FCA5247},962.5,3778,1477,39.1,1319,890,67.5,5097,2367,46.4
329,050543,13135050543,505.43,ARC 10,2015-05-21T18:32:36.000Z,{E1DC504A-83BA-4932-9E42-AE4559C95A64},1206.5,1840,764,41.5,292,122,41.8,2132,886,41.6
330,050545,13135050545,505.45,ARC 10,2015-05-21T18:32:36.000Z,{19B30B3D-D16E-4777-805B-26096A5FF473},1447.5,2839,1214,42.8,658,397,60.3,3497,1611,46.1
331,050727,13135050727,507.27,ARC 10,2015-05-21T18:32:36.000Z,{DEE88521-4515-4C4D-8C8F-E6F14396AFCA},613.8,2800,668,23.9,177,93,52.5,2977,761,25.6
332,050548,13135050548,505.48,ARC 10,2015-05-21T18:32:36.000Z,{0153A270-2AAF-416B-85C0-309BC4A9E43B},626.2,2623,940,35.8,264,29,11,2887,969,33.6
333,050546,13135050546,505.46,ARC 10,2015-05-21T18:32:36.000Z,{97298079-5CA0-4EA1-9C03-C525E2B697D0},1339.1,3898,1275,32.7,487,305,62.6,4385,1580,36
334,050726,13135050726,507.26,ARC 10,2015-05-21T18:32:36.000Z,{9A1F23C4-DEB5-4802-ABCD-4EEE528D0839},379.3,2441,1046,42.9,413,163,39.5,2854,1209,42.4
335,050608,13135050608,506.08,ARC 10,2015-05-21T18:32:36.000Z,{AB5B1B83-645D-414F-AE47-3674BCB75CF2},228.3,4086,1456,35.6,539,360,66.8,4625,1816,39.3
336,050607,13135050607,506.07,ARC 10,2015-05-21T18:32:36.000Z,{BE2BC295-859B-4EAF-B31B-DC66024D18BE},930.9,4218,1364,32.3,514,224,43.6,4732,1588,33.6
337,050542,13135050542,505.42,ARC 10,2015-05-21T18:32:36.000Z,{BBC71C1D-0EA1-4218-A190-908A9CF4303E},1649.3,357,146,40.9,1572,704,44.8,1929,850,44.1
338,050536,13135050536,505.36,ARC 10,2015-05-21T18:32:36.000Z,{D3D00461-3795-4BEC-862D-02E8105A74BA},239.7,1219,369,30.3,467,143,30.6,1686,512,30.4
339,050537,13135050537,505.37,ARC 10,2015-05-21T18:32:36.000Z,{F92B374B-1C10-409C-920A-B5E01758FB12},660,241,170,70.5,1438,842,58.6,1679,1012,60.3
340,050539,13135050539,505.39,ARC 10,2015-05-21T18:32:36.000Z,{ACF06885-A0A0-489F-AE96-5F846644168D},1246.7,598,266,44.5,894,568,63.5,1492,834,55.9
341,050544,13135050544,505.44,ARC 10,2015-05-21T18:32:36.000Z,{A1F42C0F-31CA-495B-AE06-622E803604E1},1249.2,3094,1364,44.1,731,413,56.5,3825,1777,46.5
342,050535,13135050535,505.35,ARC 10,2015-05-21T18:32:36.000Z,{A29C13F4-FF00-47B2-8A3C-506B7E847976},551.2,1640,646,39.4,562,366,65.1,2202,1012,46
343,050532,13135050532,505.32,ARC 10,2015-05-21T18:32:36.000Z,{EA5F9F2C-451A-46D3-BDB2-B84C7241E70F},1328.2,1945,820,42.2,704,552,78.4,2649,1372,51.8
344,050534,13135050534,505.34,ARC 10,2015-05-21T18:32:36.000Z,{3CB8BBD4-8EBE-461D-A16B-F75AEF8E6C01},1034.4,1718,608,35.4,976,517,53,2694,1125,41.8
345,050723,13135050723,507.23,ARC 10,2015-05-21T18:32:36.000Z,{C57012D4-C29B-4C7A-8785-15F8E25641F5},284.7,1749,815,46.6,377,127,33.7,2126,942,44.3
346,050435,13135050435,504.35,ARC 10,2015-05-21T18:32:36.000Z,{66ACC4AE-6A96-41D1-BB67-60057864435B},68.8,718,200,27.9,395,193,48.9,1113,393,35.3
347,050531,13135050531,505.31,ARC 10,2015-05-21T18:32:36.000Z,{CEE54DA9-4BE9-4A5B-B4E0-825DCF2BE653},560.7,1314,514,39.1,954,645,67.6,2268,1159,51.1
348,050533,13135050533,505.33,ARC 10,2015-05-21T18:32:36.000Z,{F0CEF250-A1EF-4855-8298-3162839E9932},776.8,1585,691,43.6,717,381,53.1,2302,1072,46.6
349,050436,13135050436,504.36,ARC 10,2015-05-21T18:32:36.000Z,{A3593F4A-59D2-493F-A6F4-10FA5F45F717},684.1,973,301,30.9,1523,815,53.5,2496,1116,44.7
350,050433,13135050433,504.33,ARC 10,2015-05-21T18:32:36.000Z,{58332029-1D90-42B6-84C0-33980C239088},450,348,162,46.6,562,353,62.8,910,515,56.6
351,050432,13135050432,504.32,ARC 10,2015-05-21T18:32:36.000Z,{1BFE45B0-FC6C-4AB0-AC85-405E3D1B2E9D},243.2,1527,584,38.2,284,153,53.9,1811,737,40.7
352,050434,13135050434,504.34,ARC 10,2015-05-21T18:32:36.000Z,{7A226E71-34EE-4EF5-83B2-002467FFA2BF},720,803,341,42.5,1403,723,51.5,2206,1064,48.2
353,050321,13135050321,503.21,ARC 10,2015-05-21T18:32:36.000Z,{1DC03BB9-94C9-4A42-AC58-97EC3F7CC5DF},-12,1434,484,33.8,17,0,0,1451,484,33.4
354,100903,13217100903,1009.03,ARC 20,2015-05-21T18:32:36.000Z,{2867E4AB-5DDE-460B-ACBF-CB293CDAB880},344,1476,400,27.1,404,225,55.7,1880,625,33.2
355,100902,13217100902,1009.02,ARC 20,2015-05-21T18:32:36.000Z,{B7088A0C-47F5-493E-B23C-EAEE1B022261},287.8,1511,668,44.2,291,172,59.1,1802,840,46.6
356,100901,13217100901,1009.01,ARC 20,2015-05-21T18:32:36.000Z,{8CFC49A4-C7F9-4D6E-B899-EEBA7DF634B2},205.7,2946,1063,36.1,324,83,25.6,3270,1146,35
357,100201,13217100201,1002.01,ARC 20,2015-05-21T18:32:36.000Z,{7FB5CB49-4576-472A-8958-4280F83E0C3A},31.4,1620,408,25.2,313,144,46,1933,552,28.6
358,100501,13217100501,1005.01,ARC 20,2015-05-21T18:32:36.000Z,{7924B377-C1AA-4F2F-8D35-94F418D84D2C},1071.6,3436,1130,32.9,1316,773,58.7,4752,1903,40
359,100800,13217100800,1008,ARC 20,2015-05-21T18:32:36.000Z,{3D79A50F-B3A5-45F6-B698-7219262600D2},98.4,2447,949,38.8,511,227,44.4,2958,1176,39.8
360,100202,13217100202,1002.02,ARC 20,2015-05-21T18:32:36.000Z,{6ADF3953-53F8-4B8D-B4D2-9D03EEC227F9},32.7,1484,406,27.4,236,116,49.2,1720,522,30.3
361,100700,13217100700,1007,ARC 20,2015-05-21T18:32:36.000Z,{281C0600-5AE3-4DE4-B361-F4BA0DE2E889},146.8,876,210,24,994,688,69.2,1870,898,48
362,100600,13217100600,1006,ARC 20,2015-05-21T18:32:36.000Z,{AADB32C1-F980-4A24-8480-B29179A94550},190.1,1189,429,36.1,697,430,61.7,1886,859,45.5
363,100502,13217100502,1005.02,ARC 20,2015-05-21T18:32:36.000Z,{A57B41E5-4839-45B8-A6C0-2D13F93F3702},434.9,1786,931,52.1,976,651,66.7,2762,1582,57.3
364,100400,13217100400,1004,ARC 20,2015-05-21T18:32:36.000Z,{6060DE7D-E181-4803-AA95-126E6254DE63},34.8,568,217,38.2,445,293,65.8,1013,510,50.3
365,100300,13217100300,1003,ARC 20,2015-05-21T18:32:36.000Z,{7734E537-37DB-4C85-8C8A-2F3C8CF87B81},190,1872,502,26.8,1163,739,63.5,3035,1241,40.9
366,100100,13217100100,1001,ARC 20,2015-05-21T18:32:36.000Z,{AFD92D30-F580-4A36-A223-EB2F5701EB95},77,3345,1080,32.3,493,328,66.5,3838,1408,36.7
367,050322,13135050322,503.22,ARC 10,2015-05-21T18:32:36.000Z,{4C61D302-E396-4DBD-A5EB-D1A76D385977},-170.5,1378,253,18.4,49,36,73.5,1427,289,20.3
368,050318,13135050318,503.18,ARC 10,2015-05-21T18:32:36.000Z,{AD8340A1-83B4-49F8-A77C-FA7929B40A06},-76.7,173,51,29.5,861,385,44.7,1034,436,42.2
369,050320,13135050320,503.20,ARC 10,2015-05-21T18:32:36.000Z,{FEDF66E3-A637-4082-9601-E846C9BFB688},165.7,587,225,38.3,869,626,72,1456,851,58.4
370,050317,13135050317,503.17,ARC 10,2015-05-21T18:32:36.000Z,{AACE9DC7-3507-421C-B745-21103B0A8117},-1340,125,91,72.8,1230,390,31.7,1355,481,35.5
371,050220,13135050220,502.20,ARC 10,2015-05-21T18:32:36.000Z,{CED86B45-1360-42EA-B1B1-180D975236F8},573.3,642,126,19.6,1949,957,49.1,2591,1083,41.8
372,050214,13135050214,502.14,ARC 10,2015-05-21T18:32:36.000Z,{BAFB2C53-3028-44D2-BB1A-7FCE8001441F},212.9,2225,636,28.6,435,251,57.7,2660,887,33.3
373,050218,13135050218,502.18,ARC 10,2015-05-21T18:32:36.000Z,{69F613CE-8BCF-4B52-BAE0-7B0D54CCB012},81.5,856,286,33.4,394,128,32.5,1250,414,33.1
374,050209,13135050209,502.09,ARC 10,2015-05-21T18:32:36.000Z,{41AA31C7-F1B3-45C1-A3BE-AD51DF010532},699.6,1670,609,36.5,1671,972,58.2,3341,1581,47.3
375,050217,13135050217,502.17,ARC 10,2015-05-21T18:32:36.000Z,{49B15BBE-8969-4B81-A618-90C0F37271D5},1133.6,1898,738,38.9,1538,584,38,3436,1322,38.5
376,050529,13135050529,505.29,ARC 10,2015-05-21T18:32:36.000Z,{8660D9CA-2512-4BF0-BBD6-BE72EEE2B46F},86.7,866,457,52.8,393,232,59,1259,689,54.7
377,050530,13135050530,505.30,ARC 10,2015-05-21T18:32:36.000Z,{80497557-88C7-490E-AB66-781951C52FCE},892.1,1726,576,33.4,206,58,28.2,1932,634,32.8
378,050538,13135050538,505.38,ARC 10,2015-05-21T18:32:36.000Z,{BFFE8E38-9C93-4758-8203-7E20837668AB},163.5,2088,696,33.3,137,85,62,2225,781,35.1
379,050525,13135050525,505.25,ARC 10,2015-05-21T18:32:36.000Z,{5E8830F5-6B44-4BAB-83C4-FB7A9DB2F2BA},250.3,2164,707,32.7,246,150,61,2410,857,35.6
380,050528,13135050528,505.28,ARC 10,2015-05-21T18:32:36.000Z,{A0E626CB-5D77-43B4-A0F2-0F4BD6233519},210.5,1300,315,24.2,264,102,38.6,1564,417,26.7
381,050605,13135050605,506.05,ARC 10,2015-05-21T18:32:36.000Z,{C8803FFF-BF04-4091-AE28-3746B1EC6198},866.1,3345,854,25.5,767,487,63.5,4112,1341,32.6
382,050606,13135050606,506.06,ARC 10,2015-05-21T18:32:36.000Z,{40ECEC54-79D3-4A67-B7B0-DCB29841818F},862.5,5289,2091,39.5,1108,591,53.3,6397,2682,41.9
383,050210,13135050210,502.10,ARC 10,2015-05-21T18:32:36.000Z,{C194C1AB-6885-4E6F-A7B0-ED7A53EDDEAA},614.5,1219,302,24.8,1264,528,41.8,2483,830,33.4
384,050213,13135050213,502.13,ARC 10,2015-05-21T18:32:36.000Z,{E87973F0-1932-426B-A1C3-C02EDB841E6E},928.2,2953,927,31.4,412,128,31.1,3365,1055,31.4
385,050208,13135050208,502.08,ARC 10,2015-05-21T18:32:36.000Z,{66E77628-E8C2-47F8-BEDF-685716622131},980,1416,485,34.3,785,229,29.2,2201,714,32.4
386,050212,13135050212,502.12,ARC 10,2015-05-21T18:32:36.000Z,{1F7581F3-3D49-4699-A2DE-0FC7ABD07015},706.2,3526,1002,28.4,198,111,56.1,3724,1113,29.9
387,050109,13135050109,501.09,ARC 10,2015-05-21T18:32:36.000Z,{B3E2240C-D664-484D-8361-4DCE87D7B486},894.4,1685,422,25,472,160,33.9,2157,582,27
388,050107,13135050107,501.07,ARC 10,2015-05-21T18:32:36.000Z,{835DD69E-6F86-4B9D-900C-3719AAF9FCA3},621,2028,592,29.2,182,107,58.8,2210,699,31.6
389,050108,13135050108,501.08,ARC 10,2015-05-21T18:32:36.000Z,{DBB0C680-38AB-4AB9-A187-ECFC093C9832},921.6,2836,837,29.5,114,97,85.1,2950,934,31.7
390,050105,13135050105,501.05,ARC 10,2015-05-21T18:32:36.000Z,{9DA31300-F5B2-40CF-BD20-02C657ACFC09},-70.9,589,166,28.2,540,298,55.2,1129,464,41.1
391,050103,13135050103,501.03,ARC 10,2015-05-21T18:32:36.000Z,{012CF0C1-015B-4141-BE1B-FADD889EA591},346.9,2537,966,38.1,655,429,65.5,3192,1395,43.7
392,050422,13135050422,504.22,ARC 10,2015-05-21T18:32:36.000Z,{3B88F86E-9DA8-4C39-B3D5-F1AA3DAE915C},477,797,370,46.4,1404,947,67.5,2201,1317,59.8
393,050304,13135050304,503.04,ARC 10,2015-05-21T18:32:36.000Z,{9E56B1E4-4639-4B51-978B-16B2AA185404},524.3,425,188,44.2,1464,866,59.2,1889,1054,55.8
394,050419,13135050419,504.19,ARC 10,2015-05-21T18:32:36.000Z,{A706BC26-F56D-42D8-852B-78B1B1C6C313},367.6,1108,394,35.6,1080,723,66.9,2188,1117,51.1
395,050306,13135050306,503.06,ARC 10,2015-05-21T18:32:36.000Z,{11E4D1E5-BBBB-4F41-B3A5-23E8A2DE1726},-79.5,513,233,45.4,551,329,59.7,1064,562,52.8
396,050106,13135050106,501.06,ARC 10,2015-05-21T18:32:36.000Z,{B74DCB54-7DB8-416C-9495-D5214E80DE7F},302.5,1884,544,28.9,1320,598,45.3,3204,1142,35.6
397,050205,13135050205,502.05,ARC 10,2015-05-21T18:32:36.000Z,{5B76DE53-DB64-40EE-9D8B-9E18E83D2AA9},-203,839,227,27.1,750,429,57.2,1589,656,41.3
398,050417,13135050417,504.17,ARC 10,2015-05-21T18:32:36.000Z,{EF47CED6-38CE-4B56-9F36-993708FE95AF},41,574,297,51.7,1121,829,74,1695,1126,66.4
399,050314,13135050314,503.14,ARC 10,2015-05-21T18:32:36.000Z,{01A1EDE4-27A1-4CAC-83B5-4B7506DCEDD1},1386.2,1438,461,32.1,1754,602,34.3,3192,1063,33.3
400,050308,13135050308,503.08,ARC 10,2015-05-21T18:32:36.000Z,{3B182360-98D8-4C3E-A63E-AF55671214A5},70.9,1076,174,16.2,77,39,50.6,1153,213,18.5
401,050309,13135050309,503.09,ARC 10,2015-05-21T18:32:36.000Z,{E0C87D4D-031C-4825-8BBB-CEBDDD04327E},133.1,2205,480,21.8,925,565,61.1,3130,1045,33.4
402,050313,13135050313,503.13,ARC 10,2015-05-21T18:32:36.000Z,{AC781A48-FC14-4EDF-8D39-15E98101849E},195,1659,518,31.2,413,271,65.6,2072,789,38.1
403,050311,13135050311,503.11,ARC 10,2015-05-21T18:32:36.000Z,{9BACDC59-D59D-4180-AA7C-503A003827CD},293.2,828,223,26.9,136,72,52.9,964,295,30.6
404,050310,13135050310,503.10,ARC 10,2015-05-21T18:32:36.000Z,{018F00DC-99F0-44FE-864C-01D57B4C7976},79.7,1740,414,23.8,552,277,50.2,2292,691,30.1
405,050424,13135050424,504.24,ARC 10,2015-05-21T18:32:36.000Z,{24E7C332-BD91-42A0-AC4B-2F1117739D50},302.1,936,284,30.3,1287,669,52,2223,953,42.9
406,050421,13135050421,504.21,ARC 10,2015-05-21T18:32:36.000Z,{F7F20C6E-1A3A-4F41-9314-5E9E53AFE716},394.8,775,297,38.3,1658,908,54.8,2433,1205,49.5
407,050315,13135050315,503.15,ARC 10,2015-05-21T18:32:36.000Z,{10115BA3-FE1C-4118-8090-4E70E804E3C8},-878.2,645,160,24.8,1355,661,48.8,2000,821,41
408,050418,13135050418,504.18,ARC 10,2015-05-21T18:32:36.000Z,{A6DAFDA1-51B2-4C28-8617-0719C0505BAD},-736.3,353,132,37.4,1648,968,58.7,2001,1100,55
409,050521,13135050521,505.21,ARC 10,2015-05-21T18:32:36.000Z,{CF98EBF1-412C-4033-B585-F428ADE77CA2},-161.8,865,262,30.3,619,400,64.6,1484,662,44.6
410,050522,13135050522,505.22,ARC 10,2015-05-21T18:32:36.000Z,{F6CAF6E9-CC78-4D37-B4F2-30E7FDD01977},254.4,991,202,20.4,754,464,61.5,1745,666,38.2
411,050520,13135050520,505.20,ARC 10,2015-05-21T18:32:36.000Z,{16D6BE79-1296-40DE-957A-A9AF79878298},66.8,567,216,38.1,1066,701,65.8,1633,917,56.2
412,050511,13135050511,505.11,ARC 10,2015-05-21T18:32:36.000Z,{62728FCB-EF91-44E3-ABCD-16B4E1D928CA},816.2,2123,876,41.3,1043,429,41.1,3166,1305,41.2
413,050714,13135050714,507.14,ARC 10,2015-05-21T18:32:36.000Z,{3B33D28C-5332-4B44-A5B3-0A7A605356D4},216.6,1443,427,29.6,280,144,51.4,1723,571,33.1
414,050429,13135050429,504.29,ARC 10,2015-05-21T18:32:36.000Z,{E6055F87-99F5-408D-868F-C26F94F2A7BD},33.4,1962,400,20.4,269,196,72.9,2231,596,26.7
415,050713,13135050713,507.13,ARC 10,2015-05-21T18:32:36.000Z,{04C28930-C1A5-44CC-B55C-40EFBFB44A30},470,2104,449,21.3,201,85,42.3,2305,534,23.2
416,050423,13135050423,504.23,ARC 10,2015-05-21T18:32:36.000Z,{D37121BF-C763-4EBB-8370-C19CBA3A06CF},765.2,984,376,38.2,1274,869,68.2,2258,1245,55.1
417,050410,13135050410,504.10,ARC 10,2015-05-21T18:32:36.000Z,{F6DCC4F8-7819-4D02-83C9-AAE10415431C},130,877,303,34.5,723,438,60.6,1600,741,46.3
418,050720,13135050720,507.20,ARC 10,2015-05-21T18:32:36.000Z,{2649171C-6E6F-4E8F-98FA-E2A3750552FA},159.5,2349,626,26.6,299,186,62.2,2648,812,30.7
419,050712,13135050712,507.12,ARC 10,2015-05-21T18:32:36.000Z,{790E7524-DBCD-4B91-BCC5-F973A8F65C94},103.8,1931,496,25.7,305,197,64.6,2236,693,31
420,050719,13135050719,507.19,ARC 10,2015-05-21T18:32:36.000Z,{C240F321-31F0-458B-9E46-60DF8F1671A1},84.3,952,153,16.1,907,488,53.8,1859,641,34.5
421,050721,13135050721,507.21,ARC 10,2015-05-21T18:32:36.000Z,{92649942-F264-419E-8C58-067459EC132D},354.7,2400,905,37.7,315,278,88.3,2715,1183,43.6
422,050709,13135050709,507.09,ARC 10,2015-05-21T18:32:36.000Z,{3EEB0465-566F-469A-A388-2D3B6E41C1A8},614.2,3124,1059,33.9,619,322,52,3743,1381,36.9
423,050715,13135050715,507.15,ARC 10,2015-05-21T18:32:36.000Z,{6BB0A5E2-B019-4DAA-A770-FCEA653531B4},34.1,1374,341,24.8,223,182,81.6,1597,523,32.7
424,050415,13135050415,504.15,ARC 10,2015-05-21T18:32:36.000Z,{700A158A-742C-4439-BDFC-1F81F0831B86},-165.8,1159,259,22.3,150,59,39.3,1309,318,24.3
425,050718,13135050718,507.18,ARC 10,2015-05-21T18:32:36.000Z,{3EBB3AFB-4731-404F-99D2-6E8C34DCC525},31.3,2208,619,28,377,197,52.3,2585,816,31.6
426,050427,13135050427,504.27,ARC 10,2015-05-21T18:32:36.000Z,{1B1394F8-D226-4726-AF41-CB071EA7DA7C},204.8,1549,412,26.6,388,320,82.5,1937,732,37.8
427,050428,13135050428,504.28,ARC 10,2015-05-21T18:32:36.000Z,{D649FC20-7F87-4A4D-AB19-649BE1AFCE4D},14.8,1765,504,28.6,164,68,41.5,1929,572,29.7
428,050416,13135050416,504.16,ARC 10,2015-05-21T18:32:36.000Z,{9D720519-D3AD-4809-9203-5E983F494E6B},72.7,793,218,27.5,252,158,62.7,1045,376,36
429,050425,13135050425,504.25,ARC 10,2015-05-21T18:32:36.000Z,{E26EFDBF-706E-49FA-877F-8FBBB689B291},-55.4,1484,380,25.6,227,75,33,1711,455,26.6
430,050526,13135050526,505.26,ARC 10,2015-05-21T18:32:36.000Z,{5EE241B9-532B-4CAC-BD8E-107BA0D2F390},114.5,656,387,59,1035,597,57.7,1691,984,58.2
431,050431,13135050431,504.31,ARC 10,2015-05-21T18:32:36.000Z,{1A1EA058-B27E-442A-B608-B707DACA1214},1583.8,1018,405,39.8,1660,791,47.7,2678,1196,44.7
432,050426,13135050426,504.26,ARC 10,2015-05-21T18:32:36.000Z,{C580A952-6E2A-49A1-AF5B-787737AD4C1E},-129.4,2003,482,24.1,257,142,55.3,2260,624,27.6
433,050430,13135050430,504.30,ARC 10,2015-05-21T18:32:36.000Z,{AE0F1C2C-5F2A-4A02-86EF-4F244BE05BAB},-18.8,1268,265,20.9,529,414,78.3,1797,679,37.8
434,009501,13121009501,95.01,ARC 10,2015-05-21T18:32:36.000Z,{5BD1C9DE-CC14-4C87-A703-8CFB3AF55477},-44.1,1292,454,35.1,345,131,38,1637,585,35.7
435,011305,13121011305,113.05,ARC 10,2015-05-21T18:32:36.000Z,{AC47A4EA-33CF-44FD-A994-A32D8530793D},-1323.6,381,107,28.1,1217,879,72.2,1598,986,61.7
436,011306,13121011306,113.06,ARC 10,2015-05-21T18:32:36.000Z,{DEEBB95E-7114-4C1C-889E-C9A3B06BA915},-462.9,408,139,34.1,581,431,74.2,989,570,57.6
437,007706,13121007706,77.06,ARC 10,2015-05-21T18:32:36.000Z,{EC7C66AD-C415-41CA-B564-BA8D9B565E00},715.8,1135,393,34.6,2443,1386,56.7,3578,1779,49.7
438,007703,13121007703,77.03,ARC 10,2015-05-21T18:32:36.000Z,{1AD692BD-0C7F-4892-93AE-ED4974B288E3},-61.2,971,384,39.5,496,357,72,1467,741,50.5
439,003700,13121003700,37,ARC 10,2015-05-21T18:32:36.000Z,{3AC1F3B1-56F5-4876-A34F-2D73F31C64B8},,0,0,,0,0,,0,0,
440,011202,13121011202,112.02,ARC 10,2015-05-21T18:32:36.000Z,{FDBD0809-0FA6-4C68-9C76-291FC7A63E72},-1226.7,763,291,38.1,851,574,67.5,1614,865,53.6
441,011100,13121011100,111,ARC 10,2015-05-21T18:32:36.000Z,{D1BD1113-05F7-4262-9E2D-54AB93E9FCD4},-446.9,600,203,33.8,460,286,62.2,1060,489,46.1
442,011201,13121011201,112.01,ARC 10,2015-05-21T18:32:36.000Z,{53A9E00E-93CF-479D-AE14-24E07CAC0081},-1516,555,85,15.3,730,519,71.1,1285,604,47
443,011303,13121011303,113.03,ARC 10,2015-05-21T18:32:36.000Z,{D1CA1E8D-5998-4F2B-9BC5-15D23C534CC6},299.6,1391,602,43.3,1898,1113,58.6,3289,1715,52.1
444,008102,13121008102,81.02,ARC 10,2015-05-21T18:32:36.000Z,{65F66CAF-6838-4989-82D2-E042B47286D5},-233.6,656,391,59.6,1602,1065,66.5,2258,1456,64.5
445,007002,13121007002,70.02,ARC 10,2015-05-21T18:32:36.000Z,{F66DD6B1-60D1-4730-80E5-B58D31FA86AC},-946.5,352,211,59.9,438,377,86.1,790,588,74.4
446,011301,13121011301,113.01,ARC 10,2015-05-21T18:32:36.000Z,{DADA39C9-A034-42C0-AC8C-BB02424F70EF},-315.5,1183,437,36.9,362,232,64.1,1545,669,43.3
447,001202,13139001202,12.02,ARC 20,2015-05-21T18:32:36.000Z,{3D7CB2BC-DA5C-4BE5-9F3C-84CA5595E9E7},97.4,1177,348,29.6,480,244,50.8,1657,592,35.7
448,000101,13139000101,1.01,ARC 20,2015-05-21T18:32:36.000Z,{C8643AB5-5F92-45B3-A0CC-FF1B5F4C470B},45.1,1254,374,29.8,368,139,37.8,1622,513,31.6
449,000701,13139000701,7.01,ARC 20,2015-05-21T18:32:36.000Z,{634BA06A-F404-42CB-BF16-B295AD5A7F4D},139.6,781,279,35.7,745,385,51.7,1526,664,43.5
450,000702,13139000702,7.02,ARC 20,2015-05-21T18:32:36.000Z,{2B89A0C2-F20D-45AD-8D6A-CFF868DC9D45},168.2,1229,412,33.5,216,86,39.8,1445,498,34.5
451,000102,13139000102,1.02,ARC 20,2015-05-21T18:32:36.000Z,{B8A85A58-386A-48BB-866F-9B7D5E0BF486},8.1,1070,340,31.8,255,70,27.5,1325,410,30.9
452,000201,13139000201,2.01,ARC 20,2015-05-21T18:32:36.000Z,{E75E56B5-A729-45E0-8819-2A86981A8E56},14.7,1515,289,19.1,442,241,54.5,1957,530,27.1
453,000302,13139000302,3.02,ARC 20,2015-05-21T18:32:36.000Z,{29F612E9-C705-4779-8055-4518FBE82477},54,2074,654,31.5,230,59,25.7,2304,713,30.9
454,000900,13139000900,9,ARC 20,2015-05-21T18:32:36.000Z,{163613E9-16AF-473E-B049-D8E3DF514960},86.1,846,139,16.4,1143,715,62.6,1989,854,42.9
455,000500,13139000500,5,ARC 20,2015-05-21T18:32:36.000Z,{6799AABE-1776-4A75-82B0-AEB886B7936D},3,1874,546,29.1,819,382,46.6,2693,928,34.5
456,001402,13139001402,14.02,ARC 20,2015-05-21T18:32:36.000Z,{091E3DDD-509F-4AF5-AF0C-FB8C8212A92C},95.1,1711,489,28.6,204,97,47.5,1915,586,30.6
457,001002,13139001002,10.02,ARC 20,2015-05-21T18:32:36.000Z,{E867B636-5A83-4168-BFC6-B21DF1799150},63.8,1354,594,43.9,643,256,39.8,1997,850,42.6
458,000800,13139000800,8,ARC 20,2015-05-21T18:32:36.000Z,{3D5D8C4D-FF25-4E4B-97CF-9A6A6959C4B8},-93.7,375,145,38.7,500,283,56.6,875,428,48.9
459,000600,13139000600,6,ARC 20,2015-05-21T18:32:36.000Z,{634220BB-C4B6-4CFA-B334-EE4F313FCAAF},42.7,1220,348,28.5,922,453,49.1,2142,801,37.4
460,000400,13139000400,4,ARC 20,2015-05-21T18:32:36.000Z,{1CAD45C6-CD62-4FC9-9042-6A1081CBEE59},83.9,1513,306,20.2,738,498,67.5,2251,804,35.7
461,007604,13121007604,76.04,ARC 10,2015-05-21T18:32:36.000Z,{FE9426BC-460B-4373-9433-8DDBF1566EED},177.5,116,53,45.7,755,582,77.1,871,635,72.9
462,007704,13121007704,77.04,ARC 10,2015-05-21T18:32:36.000Z,{713E1824-7BF3-487D-BEB1-26946D809414},-26.9,927,414,44.7,735,562,76.5,1662,976,58.7
463,007603,13121007603,76.03,ARC 10,2015-05-21T18:32:36.000Z,{FE5D6F81-F534-45ED-A14E-317779A5941F},-15,107,30,28,1938,1258,64.9,2045,1288,63
464,011427,13121011427,114.27,ARC 10,2015-05-21T18:32:36.000Z,{E03CA821-C318-41C5-9936-496B4C3EBE4D},211.1,2516,518,20.6,150,90,60,2666,608,22.8
465,011616,13121011616,116.16,ARC 10,2015-05-21T18:32:36.000Z,{6DD3AC06-6DEC-410C-A677-D1B8A57A6582},234.5,812,265,32.6,1371,477,34.8,2183,742,34
466,011617,13121011617,116.17,ARC 10,2015-05-21T18:32:36.000Z,{240451FF-8032-4EBA-B5CB-7DC59BAEF78E},582.4,2225,586,26.3,457,153,33.5,2682,739,27.6
467,011611,13121011611,116.11,ARC 10,2015-05-21T18:32:36.000Z,{FA528086-AB3E-440B-BB13-0F49EC0BEC4E},413.6,1168,257,22,1732,700,40.4,2900,957,33
468,010800,13121010800,108,ARC 10,2015-05-21T18:32:36.000Z,{EC1BBC3F-44BD-4B61-B4FE-8ABC1860CA69},91.4,906,198,21.9,1330,755,56.8,2236,953,42.6
469,980000,13121980000,9800,ARC 10,2015-05-21T18:32:36.000Z,{36C8F263-B411-4112-BE4E-EF12499DB96A},,0,0,,0,0,,0,0,
470,004300,13121004300,43,ARC 10,2015-05-21T18:32:36.000Z,{59D60265-B87D-477F-8ADF-EA3476EAEBF4},-1745,110,38,34.5,369,254,68.8,479,292,61
471,008904,13121008904,89.04,ARC 10,2015-05-21T18:32:36.000Z,{F15F429D-C435-43FA-9D1D-3B49E75480F2},266.7,1479,530,35.8,813,379,46.6,2292,909,39.7
472,008903,13121008903,89.03,ARC 10,2015-05-21T18:32:36.000Z,{37889387-8D31-46E5-93AA-381D44824D29},-1160,400,117,29.2,377,188,49.9,777,305,39.3
473,001001,13121001001,10.01,ARC 10,2015-05-21T18:32:36.000Z,{D20A0D5E-16E0-4854-BCB3-589A7FC5DE4E},1765,363,134,36.9,300,157,52.3,663,291,43.9
474,009101,13121009101,91.01,ARC 10,2015-05-21T18:32:36.000Z,{F78318F2-4EFA-4CA1-81D8-4676054CD26C},-212.9,940,235,25,1654,624,37.7,2594,859,33.1
475,001201,13121001201,12.01,ARC 10,2015-05-21T18:32:36.000Z,{EE270BA0-9EBF-40BF-B67F-7636032EEAAC},5035,888,368,41.4,1478,689,46.6,2366,1057,44.7
476,001202,13121001202,12.02,ARC 10,2015-05-21T18:32:36.000Z,{90F9C6BA-DD85-476E-80FE-706FA6F01FF1},11070,1132,403,35.6,1362,499,36.6,2494,902,36.2
477,009102,13121009102,91.02,ARC 10,2015-05-21T18:32:36.000Z,{F0762AEF-CF74-4031-94D5-7DE480AB64DA},1405,647,144,22.3,1323,453,34.2,1970,597,30.3
478,010108,13121010108,101.08,ARC 10,2015-05-21T18:32:36.000Z,{C67D36C2-36F9-4E22-B692-3673FC41F51C},-7.5,1200,269,22.4,213,82,38.5,1413,351,24.8
479,007500,13121007500,75,ARC 10,2015-05-21T18:32:36.000Z,{9A674C39-349B-45C6-A722-AF9CFE314AAE},-168.5,360,98,27.2,1061,725,68.3,1421,823,57.9
480,008101,13121008101,81.01,ARC 10,2015-05-21T18:32:36.000Z,{D41F39EC-296C-44A2-9E22-952630841303},-480,277,99,35.7,88,57,64.8,365,156,42.7
481,006000,13121006000,60,ARC 10,2015-05-21T18:32:36.000Z,{F52D2FBD-3749-458F-83BB-8BFD76BF3AB6},-1455,534,221,41.4,726,538,74.1,1260,759,60.2
482,000700,13121000700,7,ARC 10,2015-05-21T18:32:36.000Z,{D573E979-4AD0-43F3-8275-74A6EB03D605},-1081.4,187,62,33.2,136,60,44.1,323,122,37.8
483,001002,13121001002,10.02,ARC 10,2015-05-21T18:32:36.000Z,{1D29E2C6-4290-4821-8625-BDEF08B32611},-1917.1,0,0,,311,179,57.6,311,179,57.6
484,011410,13121011410,114.10,ARC 10,2015-05-21T18:32:36.000Z,{A3B999E1-FD1C-4D26-80BA-99D11BB5B6F0},32.7,2028,676,33.3,610,104,17,2638,780,29.6
485,010107,13121010107,101.07,ARC 10,2015-05-21T18:32:36.000Z,{1242D170-8FF3-4A8C-B3CD-8B73FA50FA81},47.1,661,198,30,13,0,0,674,198,29.4
486,011405,13121011405,114.05,ARC 10,2015-05-21T18:32:36.000Z,{0E41E885-7B9B-4213-BB57-C39C1629F69F},132.7,1262,320,25.4,1637,791,48.3,2899,1111,38.3
487,010106,13121010106,101.06,ARC 10,2015-05-21T18:32:36.000Z,{3D813F9F-B867-4014-9B49-9E8C7E4F451C},111.9,897,195,21.7,763,415,54.4,1660,610,36.7
488,002900,13121002900,29,ARC 10,2015-05-21T18:32:36.000Z,{48210257-424F-4676-B331-AE756D96E75C},3966.7,478,191,40,676,242,35.8,1154,433,37.5
489,010110,13121010110,101.10,ARC 10,2015-05-21T18:32:36.000Z,{F7C91010-3420-439C-8444-456EC360EA9E},571,1298,324,25,1140,419,36.8,2438,743,30.5
490,010205,13121010205,102.05,ARC 10,2015-05-21T18:32:36.000Z,{998E9DF5-76D9-458B-95F8-F64AB4CC21A9},165,1660,439,26.4,394,141,35.8,2054,580,28.2
491,010210,13121010210,102.10,ARC 10,2015-05-21T18:32:36.000Z,{FC69455E-A4E6-43EA-A3A6-E24B381751B6},199.4,1370,437,31.9,799,390,48.8,2169,827,38.1
492,010209,13121010209,102.09,ARC 10,2015-05-21T18:32:36.000Z,{2A7FE5FF-C369-4832-B24A-171552029B26},-24,621,146,23.5,2128,628,29.5,2749,774,28.2
493,008902,13121008902,89.02,ARC 10,2015-05-21T18:32:36.000Z,{857C6D2A-EFE0-4E67-A9E4-254BD5D6D014},317.5,1455,401,27.6,1761,745,42.3,3216,1146,35.6
494,008500,13121008500,85,ARC 10,2015-05-21T18:32:36.000Z,{20C80E7B-A119-48DC-9FD7-06CB4CCD9837},-682.7,372,162,43.5,688,467,67.9,1060,629,59.3
495,008601,13121008601,86.01,ARC 10,2015-05-21T18:32:36.000Z,{E598AA68-FBA7-4543-850E-13A68C5A9CC5},-525.9,541,153,28.3,959,702,73.2,1500,855,57
496,005800,13121005800,58,ARC 10,2015-05-21T18:32:36.000Z,{EB048393-0548-45B7-BE7C-A88C28E20619},-1636,173,73,42.2,268,225,84,441,298,67.6
497,007900,13121007900,79,ARC 10,2015-05-21T18:32:36.000Z,{42C742A4-4DC9-4A69-B312-ACA66544E6EB},107,1670,522,31.3,316,162,51.3,1986,684,34.4
498,010601,13121010601,106.01,ARC 10,2015-05-21T18:32:36.000Z,{384C28A9-4332-425A-B243-A632BB3223D8},-1088.2,535,164,30.7,628,421,67,1163,585,50.3
499,008700,13121008700,87,ARC 10,2015-05-21T18:32:36.000Z,{081F0949-8AE6-4499-848A-EDF833398E46},-12,484,199,41.1,1288,811,63,1772,1010,57
500,012300,13121012300,123,ARC 10,2015-05-21T18:32:36.000Z,{6169D3CA-021C-4D56-8C9F-85800E2E138D},-506.4,411,110,26.8,627,422,67.3,1038,532,51.3
501,012000,13121012000,120,ARC 10,2015-05-21T18:32:36.000Z,{5FA66028-280C-430A-8A61-56CF7D585BEF},97.8,372,200,53.8,696,499,71.7,1068,699,65.4
502,011900,13121011900,119,ARC 10,2015-05-21T18:32:36.000Z,{3420B15E-0B5A-432C-873B-48CEEF6C0F76},-253.3,194,75,38.7,1141,643,56.4,1335,718,53.8
503,011800,13121011800,118,ARC 10,2015-05-21T18:32:36.000Z,{2ACBB597-1A7B-4837-BE89-21C1A53F3BA7},-20,55,50,90.9,890,648,72.8,945,698,73.9
504,011624,13121011624,116.24,ARC 10,2015-05-21T18:32:36.000Z,{554FA341-36A3-4DA4-B118-212AB163F691},269,1136,159,14,63,15,23.8,1199,174,14.5
505,003600,13121003600,36,ARC 10,2015-05-21T18:32:36.000Z,{B971DC10-F17A-45DA-A52F-13F869A2C4E2},-1475,193,43,22.3,482,256,53.1,675,299,44.3
506,003500,13121003500,35,ARC 10,2015-05-21T18:32:36.000Z,{5088AECC-6E36-4F36-B370-D0A1094AF074},-2938,211,50,23.7,414,193,46.6,625,243,38.9
507,010208,13121010208,102.08,ARC 10,2015-05-21T18:32:36.000Z,{36FA7194-6D90-46C7-BCB5-ED37E292FA1A},260.8,570,162,28.4,1271,486,38.2,1841,648,35.2
508,011411,13121011411,114.11,ARC 10,2015-05-21T18:32:36.000Z,{C831D0BA-23F5-4AF1-B05E-3E8633497F42},-164,2133,600,28.1,652,277,42.5,2785,877,31.5
509,011412,13121011412,114.12,ARC 10,2015-05-21T18:32:36.000Z,{D2A4CA3A-845B-467E-BF92-1BA353655AAC},245.4,2275,484,21.3,997,702,70.4,3272,1186,36.2
510,011414,13121011414,114.14,ARC 10,2015-05-21T18:32:36.000Z,{4571A085-841C-4D36-AE90-43E35B6DFA39},-2.8,1567,375,23.9,1428,795,55.7,2995,1170,39.1
511,010603,13121010603,106.03,ARC 10,2015-05-21T18:32:36.000Z,{488405CC-179B-4C00-ACE3-5A11A36671A0},-786.7,213,101,47.4,952,655,68.8,1165,756,64.9
512,010604,13121010604,106.04,ARC 10,2015-05-21T18:32:36.000Z,{EA7D9D2B-E53E-4209-AA3B-3C8802E686C9},-1058.9,317,140,44.2,821,496,60.4,1138,636,55.9
513,007300,13121007300,73,ARC 10,2015-05-21T18:32:36.000Z,{AD9FB30C-5CCC-4670-B050-8A7BAFB251E4},-237.7,693,255,36.8,1779,1091,61.3,2472,1346,54.4
514,010508,13121010508,105.08,ARC 10,2015-05-21T18:32:36.000Z,{0A6622FD-8AF4-47AA-BDD8-496D8BEA43F1},522,1041,331,31.8,193,163,84.5,1234,494,40
515,010507,13121010507,105.07,ARC 10,2015-05-21T18:32:36.000Z,{4A6ED887-0C41-4954-AE74-7F6376D86E47},301.1,1318,794,60.2,1369,873,63.8,2687,1667,62
516,010511,13121010511,105.11,ARC 10,2015-05-21T18:32:36.000Z,{9B186274-90CE-46FF-BA76-EEFE08F90626},490.5,2058,861,41.8,592,335,56.6,2650,1196,45.1
517,011626,13121011626,116.26,ARC 10,2015-05-21T18:32:36.000Z,{9579DDF4-3554-4B32-8CB5-359F4CDEED96},1038.6,1543,379,24.6,950,487,51.3,2493,866,34.7
518,011622,13121011622,116.22,ARC 10,2015-05-21T18:32:36.000Z,{CF52F47D-EB73-4BAF-BF06-2E5BD897F434},440.8,2727,881,32.3,133,19,14.3,2860,900,31.5
519,011424,13121011424,114.24,ARC 10,2015-05-21T18:32:36.000Z,{894F33B2-D71A-49B5-8DE7-5DDD8E125CB5},342.6,1797,429,23.9,306,16,5.2,2103,445,21.2
520,011422,13121011422,114.22,ARC 10,2015-05-21T18:32:36.000Z,{08524CEE-CCE4-4258-883A-F42BE352235D},353.1,909,219,24.1,777,332,42.7,1686,551,32.7
521,011505,13121011505,115.05,ARC 10,2015-05-21T18:32:36.000Z,{8AAD0965-1DC1-4DE8-9BB5-FFEB835B6ADA},79.4,1303,271,20.8,104,27,26,1407,298,21.2
522,010123,13121010123,101.23,ARC 10,2015-05-21T18:32:36.000Z,{977C8961-9B37-4B58-A65E-6856762DB63C},-578.2,920,228,24.8,921,631,68.5,1841,859,46.7
523,000100,13121000100,1,ARC 10,2015-05-21T18:32:36.000Z,{2635916F-B888-460C-AC5D-B9124A583553},200,1507,385,25.5,333,61,18.3,1840,446,24.2
524,000200,13121000200,2,ARC 10,2015-05-21T18:32:36.000Z,{2765DE5A-CCBD-4662-A76A-545A732A20DB},2.7,1766,460,26,930,364,39.1,2696,824,30.6
525,009402,13121009402,94.02,ARC 10,2015-05-21T18:32:36.000Z,{11BFB4D9-A554-45CE-81A1-402DA1D39DFA},-206,204,68,33.3,2116,817,38.6,2320,885,38.1
526,001100,13121001100,11,ARC 10,2015-05-21T18:32:36.000Z,{791A6776-0EB5-4183-AEF4-60E6FE7A01AB},5415,1223,364,29.8,1178,307,26.1,2401,671,27.9
527,000400,13121000400,4,ARC 10,2015-05-21T18:32:36.000Z,{5338B04A-A058-4002-9C0C-9A21200BDD57},46.7,544,218,40.1,404,120,29.7,948,338,35.7
528,009200,13121009200,92,ARC 10,2015-05-21T18:32:36.000Z,{AFA1AB6E-8AF9-45CF-A937-8A4F3C8A4A8F},1725.7,752,180,23.9,2303,871,37.8,3055,1051,34.4
529,008201,13121008201,82.01,ARC 10,2015-05-21T18:32:36.000Z,{364330A6-5C68-4D52-A0A1-4854F9BDE552},175.2,1479,463,31.3,1021,754,73.8,2500,1217,48.7
530,007808,13121007808,78.08,ARC 10,2015-05-21T18:32:36.000Z,{EC8F2CAA-DD98-4FFB-AFB9-E84943B625FE},483.3,100,24,24,967,670,69.3,1067,694,65
531,007806,13121007806,78.06,ARC 10,2015-05-21T18:32:36.000Z,{4F5DE930-CB0A-4AD0-8DBE-AF923AD7F497},122.6,1082,465,43,1060,833,78.6,2142,1298,60.6
532,008800,13121008800,88,ARC 10,2015-05-21T18:32:36.000Z,{B6119857-90E0-48A5-94A7-29A2CA7A1EAF},421.8,1435,375,26.1,614,200,32.6,2049,575,28.1
533,008602,13121008602,86.02,ARC 10,2015-05-21T18:32:36.000Z,{09517D09-FF57-4F94-AB32-8EB1712F2C11},-1300,189,62,32.8,225,143,63.6,414,205,49.5
534,010121,13121010121,101.21,ARC 10,2015-05-21T18:32:36.000Z,{934050F8-D237-4FBD-BD7F-CAF28DCF2678},547.5,834,198,23.7,282,96,34,1116,294,26.3
535,010119,13121010119,101.19,ARC 10,2015-05-21T18:32:36.000Z,{5EC5FFC2-B0BF-40F5-BC1F-4B2C9D2912A0},251.3,276,115,41.7,1553,968,62.3,1829,1083,59.2
536,010211,13121010211,102.11,ARC 10,2015-05-21T18:32:36.000Z,{2DCF3AD9-BF2B-4FA7-9AF4-AA39006D2828},514,863,214,24.8,380,231,60.8,1243,445,35.8
537,009801,13121009801,98.01,ARC 10,2015-05-21T18:32:36.000Z,{21417D1B-98DE-43C1-91AE-7483CAC7DE2E},290,1364,495,36.3,380,134,35.3,1744,629,36.1
538,009603,13121009603,96.03,ARC 10,2015-05-21T18:32:36.000Z,{33BF0DD1-8A1B-4454-8AC3-4CD43BC8D44C},1684.3,857,313,36.5,1147,550,48,2004,863,43.1
539,009601,13121009601,96.01,ARC 10,2015-05-21T18:32:36.000Z,{1D3CEA21-14EF-45CB-AD0B-3613B6777FEF},1743.3,530,163,30.8,707,292,41.3,1237,455,36.8
540,007705,13121007705,77.05,ARC 10,2015-05-21T18:32:36.000Z,{656D09A3-C70A-4350-8109-F00469210CFB},496.9,445,150,33.7,1442,967,67.1,1887,1117,59.2
541,011612,13121011612,116.12,ARC 10,2015-05-21T18:32:37.000Z,{7A118793-2AAF-4D6F-8DEA-9CC1F9369E43},-353.1,1063,234,22,36,0,0,1099,234,21.3
542,011623,13121011623,116.23,ARC 10,2015-05-21T18:32:37.000Z,{306AFC28-CDC4-4A2B-B28A-4BDCFA208400},1144.4,2817,942,33.4,1114,413,37.1,3931,1355,34.5
543,011625,13121011625,116.25,ARC 10,2015-05-21T18:32:37.000Z,{8E6665F9-314E-495B-9B21-16D924F5D731},935,1578,403,25.5,890,282,31.7,2468,685,27.8
544,011619,13121011619,116.19,ARC 10,2015-05-21T18:32:37.000Z,{2B81D9B3-D3FD-4660-B915-617B6722876E},566.4,878,182,20.7,1882,305,16.2,2760,487,17.6
545,011621,13121011621,116.21,ARC 10,2015-05-21T18:32:37.000Z,{87C96C9C-A65E-4A99-A688-7C03D8B1800F},204.7,1502,438,29.2,669,175,26.2,2171,613,28.2
546,000500,13121000500,5,ARC 10,2015-05-21T18:32:37.000Z,{AC823D84-FE45-495D-ABA5-CC9278E7768D},750,1174,366,31.2,991,427,43.1,2165,793,36.6
547,009300,13121009300,93,ARC 10,2015-05-21T18:32:37.000Z,{BE3FC11E-9D31-4347-A7A8-A7B6006004DC},-242.2,1484,509,34.3,741,296,39.9,2225,805,36.2
548,009900,13121009900,99,ARC 10,2015-05-21T18:32:37.000Z,{683D85E7-CE42-4B2A-A5E9-D08191326F18},167.3,1358,371,27.3,620,246,39.7,1978,617,31.2
549,009000,13121009000,90,ARC 10,2015-05-21T18:32:37.000Z,{C6359867-02A5-49AF-AD3D-8A32D3E0BFCD},693.3,1112,299,26.9,549,223,40.6,1661,522,31.4
550,009700,13121009700,97,ARC 10,2015-05-21T18:32:37.000Z,{7F3B82D3-ECCB-45DE-9F3A-9042358A42D8},-94.3,1326,406,30.6,183,10,5.5,1509,416,27.6
551,010206,13121010206,102.06,ARC 10,2015-05-21T18:32:37.000Z,{C17DC910-9A99-4D6E-8A03-8DC70D9D1116},9.1,1804,667,37,126,32,25.4,1930,699,36.2
552,010204,13121010204,102.04,ARC 10,2015-05-21T18:32:37.000Z,{912B7C97-2068-49F9-80E7-A35588B3C640},2.4,1805,446,24.7,33,16,48.5,1838,462,25.1
553,007100,13121007100,71,ARC 10,2015-05-21T18:32:37.000Z,{8BC273E0-BD92-4155-9C97-33E8BD472292},-1778,314,132,42,396,287,72.5,710,419,59
554,006801,13121006801,68.01,ARC 10,2015-05-21T18:32:37.000Z,{9A472116-4C77-4BD8-8AB5-B209EFDEE3E4},-766.7,0,0,,0,0,,0,0,
555,006900,13121006900,69,ARC 10,2015-05-21T18:32:37.000Z,{37D6CF58-CEFF-451E-83B5-FA47609FC6DF},-113.3,604,211,34.9,542,286,52.8,1146,497,43.4
556,005200,13121005200,52,ARC 10,2015-05-21T18:32:37.000Z,{DD9CB991-2534-42EC-AE25-415DACAD6A66},687.8,1457,408,28,428,169,39.5,1885,577,30.6
557,005000,13121005000,50,ARC 10,2015-05-21T18:32:37.000Z,{3DE82D36-C813-4EA8-9B7A-A6C08C08C18F},-44,520,227,43.7,357,159,44.5,877,386,44
558,001500,13121001500,15,ARC 10,2015-05-21T18:32:37.000Z,{214A7487-1B03-4B2C-A700-C2AED94DB781},302.5,836,347,41.5,1432,503,35.1,2268,850,37.5
559,007807,13121007807,78.07,ARC 10,2015-05-21T18:32:37.000Z,{45DA8D8E-B087-4AF3-A8F4-964D20838D7E},-449.1,445,82,18.4,452,340,75.2,897,422,47
560,010510,13121010510,105.10,ARC 10,2015-05-21T18:32:37.000Z,{DEF2A2EE-D1DA-4299-A030-55D608082B61},766.3,3457,1254,36.3,2548,1513,59.4,6005,2767,46.1
561,010512,13121010512,105.12,ARC 10,2015-05-21T18:32:37.000Z,{0AD49A45-2BDE-4168-BF25-D5AF3103F20B},213.9,689,262,38,1581,1126,71.2,2270,1388,61.1
562,007802,13121007802,78.02,ARC 10,2015-05-21T18:32:37.000Z,{0D7D90AF-5039-45D7-B991-92FA1537EC48},332.6,2041,747,36.6,1075,618,57.5,3116,1365,43.8
563,007805,13121007805,78.05,ARC 10,2015-05-21T18:32:37.000Z,{E9CBFDA6-0E95-405D-BC94-646BDD823278},-118.6,576,222,38.5,662,446,67.4,1238,668,54
564,011618,13121011618,116.18,ARC 10,2015-05-21T18:32:37.000Z,{D5C6F5CD-3FB2-4EB9-8CE1-68BACF256256},1114.5,928,161,17.3,342,81,23.7,1270,242,19.1
565,011610,13121011610,116.10,ARC 10,2015-05-21T18:32:37.000Z,{2813427D-3E21-4FF3-9315-276429E52DDA},-1.7,1306,394,30.2,540,223,41.3,1846,617,33.4
566,011614,13121011614,116.14,ARC 10,2015-05-21T18:32:37.000Z,{46EDF576-B6F3-4240-B9DF-7AF339748F81},2205.5,3055,656,21.5,2730,905,33.2,5785,1561,27
567,011620,13121011620,116.20,ARC 10,2015-05-21T18:32:37.000Z,{6B8A9DA4-89EE-447F-BC6A-15189760898A},719,2804,1015,36.2,254,81,31.9,3058,1096,35.8
568,011420,13121011420,114.20,ARC 10,2015-05-21T18:32:37.000Z,{D45B3F25-FCB4-4162-A6D1-7354B69D6C9B},670,452,218,48.2,1797,1133,63,2249,1351,60.1
569,011613,13121011613,116.13,ARC 10,2015-05-21T18:32:37.000Z,{71CA65EF-EBEE-4143-B957-9DA794794AEF},398.4,1495,344,23,476,220,46.2,1971,564,28.6
570,011426,13121011426,114.26,ARC 10,2015-05-21T18:32:37.000Z,{615A664E-D274-4D82-9D3D-85798073E1BE},-91.7,719,228,31.7,19,0,0,738,228,30.9
571,011425,13121011425,114.25,ARC 10,2015-05-21T18:32:37.000Z,{D8BEEA90-7CB4-4F95-A6E5-00C4EB859D16},176.7,1855,453,24.4,294,135,45.9,2149,588,27.4
572,011423,13121011423,114.23,ARC 10,2015-05-21T18:32:37.000Z,{D49B3515-6A63-4252-ADEA-845D45D4C9B9},72.8,1457,297,20.4,344,139,40.4,1801,436,24.2
573,011418,13121011418,114.18,ARC 10,2015-05-21T18:32:37.000Z,{24C0DF43-7DC8-41FB-B411-33D959E3F5EC},64,2182,571,26.2,112,72,64.3,2294,643,28
574,002600,13121002600,26,ARC 10,2015-05-21T18:32:37.000Z,{8DED5141-DD20-4308-B948-3E1F908A20DC},-1160,34,11,32.4,356,258,72.5,390,269,69
575,001700,13121001700,17,ARC 10,2015-05-21T18:32:37.000Z,{E89A76C7-8E72-4E10-86B2-5CD0E8EDDB27},588,326,124,38,1260,660,52.4,1586,784,49.4
576,001400,13121001400,14,ARC 10,2015-05-21T18:32:37.000Z,{888021FA-D8C8-45D0-8AC1-AAAFDA94B640},173.3,524,124,23.7,754,287,38.1,1278,411,32.2
577,003000,13121003000,30,ARC 10,2015-05-21T18:32:37.000Z,{C4E07105-D3F8-4FFE-9387-C5647A8C728B},1808,842,288,34.2,709,279,39.4,1551,567,36.6
578,011000,13121011000,110,ARC 10,2015-05-21T18:32:37.000Z,{D0705EBB-C06C-47F8-8113-DD6DF42DC53E},-1281.8,313,115,36.7,606,431,71.1,919,546,59.4
579,007400,13121007400,74,ARC 10,2015-05-21T18:32:37.000Z,{E7E8F9A3-DCCA-42DC-9F3F-2303B8BC90D0},-930,132,65,49.2,795,453,57,927,518,55.9
580,006400,13121006400,64,ARC 10,2015-05-21T18:32:37.000Z,{FE0AE389-52F4-4F93-A0FD-61D49E2AEB0E},-3252,59,1,1.7,223,145,65,282,146,51.8
581,005300,13121005300,53,ARC 10,2015-05-21T18:32:37.000Z,{F5436BCE-7479-42D7-BDA1-CA9063A94309},612.2,1049,367,35,482,172,35.7,1531,539,35.2
582,005502,13121005502,55.02,ARC 10,2015-05-21T18:32:37.000Z,{2A48050A-9686-4D44-8946-B7EFE06AE0C1},1895.7,200,95,47.5,945,621,65.7,1145,716,62.5
583,008202,13121008202,82.02,ARC 10,2015-05-21T18:32:37.000Z,{72521991-5D82-4A63-BCE2-EA5E228EDF25},-907,308,129,41.9,420,301,71.7,728,430,59.1
584,010513,13121010513,105.13,ARC 10,2015-05-21T18:32:37.000Z,{B0E07062-E196-41CA-A86D-8B0D222D3ED5},532.7,3155,1455,46.1,1487,1005,67.6,4642,2460,53
585,010304,13121010304,103.04,ARC 10,2015-05-21T18:32:37.000Z,{CCCD7843-1EC1-4B71-9F97-16F7A6C7A33B},532.8,3974,1704,42.9,455,146,32.1,4429,1850,41.8
586,010303,13121010303,103.03,ARC 10,2015-05-21T18:32:37.000Z,{7F213573-FFB0-4910-80C9-339E9695404C},237.1,2111,749,35.5,1241,776,62.5,3352,1525,45.5
587,010514,13121010514,105.14,ARC 10,2015-05-21T18:32:37.000Z,{C4D7C9A2-3A93-41FF-B0E9-0978A10F00FD},374.3,2674,1035,38.7,1040,620,59.6,3714,1655,44.6
588,010301,13121010301,103.01,ARC 10,2015-05-21T18:32:37.000Z,{3C2D73F0-75BA-4C64-BC1A-95C7AA0AF792},363.3,3982,1709,42.9,1400,814,58.1,5382,2523,46.9
589,010400,13121010400,104,ARC 10,2015-05-21T18:32:37.000Z,{7EB4C080-83C5-4B6D-978C-B2C4C5001874},18.5,2093,746,35.6,682,410,60.1,2775,1156,41.7
590,011421,13121011421,114.21,ARC 10,2015-05-21T18:32:37.000Z,{049A3602-6230-4441-BD79-443D0271F3CD},396,491,155,31.6,1016,449,44.2,1507,604,40.1
591,011416,13121011416,114.16,ARC 10,2015-05-21T18:32:37.000Z,{9BB98CBA-7082-4D98-B45B-332882826F68},147.3,1920,490,25.5,136,94,69.1,2056,584,28.4
592,011506,13121011506,115.06,ARC 10,2015-05-21T18:32:37.000Z,{41AD8F77-25B1-4C3D-9AD2-64F2B43BB39A},136.8,2115,420,19.9,73,48,65.8,2188,468,21.4
593,011417,13121011417,114.17,ARC 10,2015-05-21T18:32:37.000Z,{A8BDE77F-4060-49B2-8807-1DD5B3BA99EA},246.6,1396,202,14.5,495,355,71.7,1891,557,29.5
594,007001,13121007001,70.01,ARC 10,2015-05-21T18:32:37.000Z,{8FC07476-D136-4DA2-ABD8-5E0741FB730D},-579.4,689,252,36.6,474,372,78.5,1163,624,53.7
595,006700,13121006700,67,ARC 10,2015-05-21T18:32:37.000Z,{540C8A7C-9F87-48F8-9B36-77DE9F84DD60},-236.9,602,231,38.4,596,414,69.5,1198,645,53.8
596,006300,13121006300,63,ARC 10,2015-05-21T18:32:37.000Z,{0055B33C-C47F-4DBC-BD25-6671A9255958},90,307,124,40.4,352,294,83.5,659,418,63.4
597,005700,13121005700,57,ARC 10,2015-05-21T18:32:37.000Z,{4048E966-40F6-4335-87D9-AA517574829D},540,105,48,45.7,407,244,60,512,292,57
598,006500,13121006500,65,ARC 10,2015-05-21T18:32:37.000Z,{9C4914DA-43B8-496C-9D7F-AB10CA7727A1},-766.2,907,340,37.5,325,190,58.5,1232,530,43
599,005501,13121005501,55.01,ARC 10,2015-05-21T18:32:37.000Z,{49A9086A-2AED-476E-B03B-A40DE38D6540},-122,332,105,31.6,537,387,72.1,869,492,56.6
600,004900,13121004900,49,ARC 10,2015-05-21T18:32:37.000Z,{378A006A-D521-49E6-BECF-13165AAEFEAF},1110,699,159,22.7,346,204,59,1045,363,34.7
601,004800,13121004800,48,ARC 10,2015-05-21T18:32:37.000Z,{0E3AA4C8-C28D-455A-91C8-F37EAE5BFFB7},-6635,7,0,0,449,296,65.9,456,296,64.9
602,002800,13121002800,28,ARC 10,2015-05-21T18:32:37.000Z,{36E579A1-B266-4CF6-A4AA-62A7DDCFA297},2296.7,143,81,56.6,877,449,51.2,1020,530,52
603,011419,13121011419,114.19,ARC 10,2015-05-21T18:32:37.000Z,{F43AAE75-882A-46B6-8D9E-D1A4517EB218},528.5,1945,551,28.3,346,195,56.4,2291,746,32.6
604,011503,13121011503,115.03,ARC 10,2015-05-21T18:32:37.000Z,{DBF6C28D-4402-43C4-8740-BA0368D6EAD7},259.6,2752,625,22.7,260,13,5,3012,638,21.2
605,011615,13121011615,116.15,ARC 10,2015-05-21T18:32:37.000Z,{A462F19A-540A-4365-9A60-2D635DE583BF},350.8,2518,574,22.8,542,116,21.4,3060,690,22.5
606,011504,13121011504,115.04,ARC 10,2015-05-21T18:32:37.000Z,{1C2DCFF2-E085-4BA3-A736-E0229D70AB61},250,3538,836,23.6,214,53,24.8,3752,889,23.7
607,010515,13121010515,105.15,ARC 10,2015-05-21T18:32:37.000Z,{C3754585-41C3-49B0-A1BA-7BB31E778858},616.1,1187,631,53.2,601,203,33.8,1788,834,46.6
608,010516,13121010516,105.16,ARC 10,2015-05-21T18:32:37.000Z,{E01C6290-2CF6-40EA-B009-788384788DC6},449.1,2201,773,35.1,633,438,69.2,2834,1211,42.7
609,010120,13121010120,101.20,ARC 10,2015-05-21T18:32:37.000Z,{C33584EE-312E-4939-99B3-CBEBD16D2D59},1057.5,432,104,24.1,627,290,46.3,1059,394,37.2
610,010117,13121010117,101.17,ARC 10,2015-05-21T18:32:37.000Z,{702C2B07-6DC5-402E-BE70-FA244DCBF263},678,196,75,38.3,1351,533,39.5,1547,608,39.3
611,001800,13121001800,18,ARC 10,2015-05-21T18:32:37.000Z,{B216E972-65C2-4692-8BE2-93A2A1DFD023},915,816,282,34.6,1719,734,42.7,2535,1016,40.1
612,001300,13121001300,13,ARC 10,2015-05-21T18:32:37.000Z,{B45BE603-6A6B-4EA2-9081-BAB4356B8F63},348,943,393,41.7,1229,624,50.8,2172,1017,46.8
613,001900,13121001900,19,ARC 10,2015-05-21T18:32:37.000Z,{B4F8BF9A-3DDD-4651-B484-96FD67975D4B},6302.5,346,99,28.6,770,329,42.7,1116,428,38.4
614,002100,13121002100,21,ARC 10,2015-05-21T18:32:37.000Z,{6918318B-8206-4B8C-83EB-4D8A1862B9A4},2926.7,299,114,38.1,514,359,69.8,813,473,58.2
615,004400,13121004400,44,ARC 10,2015-05-21T18:32:37.000Z,{327FD610-0C07-4CAD-BCAC-7F8789D3363D},1736.7,23,9,39.1,738,321,43.5,761,330,43.4
616,003200,13121003200,32,ARC 10,2015-05-21T18:32:37.000Z,{41D5C601-10C5-41AC-913A-451D1E3A218B},1287.5,534,160,30,681,362,53.2,1215,522,43
617,004200,13121004200,42,ARC 10,2015-05-21T18:32:37.000Z,{904DC97D-4EAF-4870-A09D-624E4A583612},-562,204,85,41.7,1081,613,56.7,1285,698,54.3
618,003800,13121003800,38,ARC 10,2015-05-21T18:32:37.000Z,{B6D342DB-70C8-4128-AD50-E02E0FD973B5},5646.7,44,26,59.1,107,72,67.3,151,98,64.9
619,002500,13121002500,25,ARC 10,2015-05-21T18:32:37.000Z,{402FDB21-33A4-4FB8-92A7-77E810ED4BB1},-256.7,161,82,50.9,631,435,68.9,792,517,65.3
620,002300,13121002300,23,ARC 10,2015-05-21T18:32:37.000Z,{74C63DEB-770C-4EFC-94B5-D3FC582445E0},-3095,143,79,55.2,313,246,78.6,456,325,71.3
621,001608,13139001608,16.08,ARC 20,2015-05-21T18:32:37.000Z,{3D8B38C1-2A1E-4C7E-AED5-6E4434905C2C},567.6,1690,438,25.9,147,0,0,1837,438,23.8
622,001603,13139001603,16.03,ARC 20,2015-05-21T18:32:37.000Z,{F50F3731-EEB0-47E7-82A3-93E75C515DCF},104.9,1447,453,31.3,159,93,58.5,1606,546,34
623,010118,13121010118,101.18,ARC 10,2015-05-21T18:32:37.000Z,{25EE3514-E65D-4441-8DE1-D05CA5B99BDA},800,406,112,27.6,1657,1106,66.7,2063,1218,59
624,010113,13121010113,101.13,ARC 10,2015-05-21T18:32:37.000Z,{53197745-9AE3-4E52-8228-089BA8976E4E},1258.9,555,160,28.8,2234,1157,51.8,2789,1317,47.2
625,010115,13121010115,101.15,ARC 10,2015-05-21T18:32:37.000Z,{01DCC9BE-CDA3-4C38-8701-5D272401BCBA},475.4,634,174,27.4,294,96,32.7,928,270,29.1
626,010122,13121010122,101.22,ARC 10,2015-05-21T18:32:37.000Z,{5492E9E1-1E8C-4FE6-99CA-9BFB80417F7D},900.8,621,77,12.4,1982,559,28.2,2603,636,24.4
627,010114,13121010114,101.14,ARC 10,2015-05-21T18:32:37.000Z,{89FE2A09-CA1F-42A1-9B42-A81D67E0CDFF},221.9,1210,257,21.2,1535,529,34.5,2745,786,28.6
628,000600,13121000600,6,ARC 10,2015-05-21T18:32:37.000Z,{8BB3C437-3B70-4474-9CCC-22523CBEC667},4160,399,144,36.1,1447,775,53.6,1846,919,49.8
629,006601,13121006601,66.01,ARC 10,2015-05-21T18:32:37.000Z,{2BD1BEC0-1179-437A-8A59-285D0129DA2C},-670,394,203,51.5,322,151,46.9,716,354,49.4
630,006602,13121006602,66.02,ARC 10,2015-05-21T18:32:37.000Z,{06DEC264-36AA-4419-858D-F18D0B87B8D0},-1380,35,17,48.6,279,224,80.3,314,241,76.8
631,006200,13121006200,62,ARC 10,2015-05-21T18:32:37.000Z,{CA5B6E08-B87A-49CC-9093-1BF251933BC1},-757.5,136,68,50,295,264,89.5,431,332,77
632,006100,13121006100,61,ARC 10,2015-05-21T18:32:37.000Z,{9E771DC2-6814-4B6F-967B-F619CDC63861},-950,764,356,46.6,482,387,80.3,1246,743,59.6
633,001600,13121001600,16,ARC 10,2015-05-21T18:32:37.000Z,{3B26F3BE-CC25-48B4-837F-A330C83C9518},1705,331,57,17.2,938,310,33,1269,367,28.9
634,003100,13121003100,31,ARC 10,2015-05-21T18:32:37.000Z,{7162ED8F-9784-4820-A64E-4A8C1533EB6C},-90,331,82,24.8,353,223,63.2,684,305,44.6
635,006802,13121006802,68.02,ARC 10,2015-05-21T18:32:37.000Z,{5085504D-FD41-4255-9220-9F79C32243D3},206.7,35,20,57.1,260,172,66.2,295,192,65.1
636,007602,13121007602,76.02,ARC 10,2015-05-21T18:32:37.000Z,{48F7B914-C919-43DE-9537-8A301FFE9295},-330.8,415,183,44.1,566,339,59.9,981,522,53.2
637,001606,13139001606,16.06,ARC 20,2015-05-21T18:32:37.000Z,{AD388A7C-FC5F-40A3-B585-4E0B3F53E6D1},543.6,630,217,34.4,612,346,56.5,1242,563,45.3
638,001101,13139001101,11.01,ARC 20,2015-05-21T18:32:37.000Z,{36F31E44-5BE6-409B-A875-921FA3277934},-808.1,199,72,36.2,921,579,62.9,1120,651,58.1
639,001605,13139001605,16.05,ARC 20,2015-05-21T18:32:37.000Z,{A3D1D434-11E4-498B-BA1D-39606902EA33},357.6,1459,450,30.8,198,95,48,1657,545,32.9
640,001604,13139001604,16.04,ARC 20,2015-05-21T18:32:37.000Z,{FD2B7B7E-C8C5-4CC1-B834-29E1E2BF0120},470.2,1606,553,34.4,264,134,50.8,1870,687,36.7
641,001502,13139001502,15.02,ARC 20,2015-05-21T18:32:37.000Z,{C8B88F6D-636F-4280-BF9D-3F49A304CEBC},46.9,1243,291,23.4,266,96,36.1,1509,387,25.6
642,001607,13139001607,16.07,ARC 20,2015-05-21T18:32:37.000Z,{CB3BABC6-13D5-4EE2-BF2E-3C4BC889DAD5},211.3,1414,404,28.6,243,122,50.2,1657,526,31.7
643,001302,13139001302,13.02,ARC 20,2015-05-21T18:32:37.000Z,{272903FB-E839-41CE-8ED9-C795F2E119EF},122.1,1530,321,21,129,101,78.3,1659,422,25.4
644,001301,13139001301,13.01,ARC 20,2015-05-21T18:32:37.000Z,{24F5F24F-9AF4-40C4-A349-76C4BEF969B4},149.1,1454,483,33.2,381,162,42.5,1835,645,35.1
645,001403,13139001403,14.03,ARC 20,2015-05-21T18:32:37.000Z,{904A4144-0E6F-4264-82B4-CB34CA16A279},214.4,599,164,27.4,743,515,69.3,1342,679,50.6
646,001404,13139001404,14.04,ARC 20,2015-05-21T18:32:37.000Z,{5BE27A78-F2CC-4F86-BCC2-C03A9400AB80},89.3,979,274,28,861,345,40.1,1840,619,33.6
647,010212,13121010212,102.12,ARC 10,2015-05-21T18:32:37.000Z,{1033042D-4E30-48CF-968C-BE0DADBC5BF4},-163.8,709,245,34.6,1055,477,45.2,1764,722,40.9
648,009802,13121009802,98.02,ARC 10,2015-05-21T18:32:37.000Z,{643F230B-1BAB-4B5C-AB25-31CB2B6CF7B6},110.2,1072,291,27.1,715,141,19.7,1787,432,24.2
649,009403,13121009403,94.03,ARC 10,2015-05-21T18:32:37.000Z,{678B083D-EF09-4995-86D5-6D9F1EC0062C},3148,668,316,47.3,2044,711,34.8,2712,1027,37.9
650,009404,13121009404,94.04,ARC 10,2015-05-21T18:32:37.000Z,{6FF9BE4C-D5F5-4D52-89E4-EE03B74C5219},1475,1251,298,23.8,987,250,25.3,2238,548,24.5
651,010001,13121010001,100.01,ARC 10,2015-05-21T18:32:37.000Z,{0A225A02-E76B-4805-A57C-8BC936B81329},570.6,1553,525,33.8,693,239,34.5,2246,764,34
652,009602,13121009602,96.02,ARC 10,2015-05-21T18:32:37.000Z,{2161F245-A3D5-4C0F-ACDF-393BFBD8F9DD},1134.4,1359,543,40,1249,456,36.5,2608,999,38.3
653,010002,13121010002,100.02,ARC 10,2015-05-21T18:32:37.000Z,{82EF89A9-C4E4-4E6C-8157-5257A7E64B1B},793.3,2081,618,29.7,847,171,20.2,2928,789,26.9
654,009502,13121009502,95.02,ARC 10,2015-05-21T18:32:37.000Z,{70C05DB3-CC93-4817-B40D-FF17FB84D0C7},600,817,246,30.1,1011,444,43.9,1828,690,37.7
655,008000,13121008000,80,ARC 10,2015-05-21T18:32:37.000Z,{C5FE6E21-6AC9-4DB5-B933-DC53E57466A5},-400.9,1220,418,34.3,542,342,63.1,1762,760,43.1
656,003900,13121003900,39,ARC 10,2015-05-21T18:32:37.000Z,{5FB95E1B-28C4-4A1A-8054-7974CFEE7A83},-3650,231,115,49.8,283,231,81.6,514,346,67.3
657,004100,13121004100,41,ARC 10,2015-05-21T18:32:37.000Z,{7B5A0F63-3836-472F-AD4A-B78AE4D733BE},-1406,172,54,31.4,491,364,74.1,663,418,63
658,002400,13121002400,24,ARC 10,2015-05-21T18:32:37.000Z,{164D5205-3730-487C-9E82-23C387D04D9D},-388,325,98,30.2,387,268,69.3,712,366,51.4
659,004000,13121004000,40,ARC 10,2015-05-21T18:32:37.000Z,{9D3F2B8E-C69D-4DAD-BD3B-ED5F1172327B},-1558.3,548,197,35.9,292,247,84.6,840,444,52.9
660,008400,13121008400,84,ARC 10,2015-05-21T18:32:37.000Z,{652D3753-0D83-4037-A650-2C4BA31A8C61},-3184.3,311,71,22.8,854,543,63.6,1165,614,52.7
661,008302,13121008302,83.02,ARC 10,2015-05-21T18:32:37.000Z,{9B92AEA5-DCFA-46A6-91B2-40D488C5258D},-1161.4,354,129,36.4,359,233,64.9,713,362,50.8
662,008301,13121008301,83.01,ARC 10,2015-05-21T18:32:37.000Z,{265614C5-40A6-4F11-89EA-88967630804B},-941,412,120,29.1,541,452,83.5,953,572,60
663,007200,13121007200,72,ARC 10,2015-05-21T18:32:37.000Z,{2B49B064-78D1-4973-84EA-0F5985D7CF1C},-701.7,314,184,58.6,348,271,77.9,662,455,68.7
664,001501,13139001501,15.01,ARC 20,2015-05-21T18:32:37.000Z,{9E6D43BD-12C1-463F-AE1A-3B03481440EE},82.7,1233,283,23,263,113,43,1496,396,26.5
665,001102,13139001102,11.02,ARC 20,2015-05-21T18:32:37.000Z,{FF6D2579-3591-4861-8D0C-846437B721C2},991.4,562,157,27.9,494,371,75.1,1056,528,50
666,001201,13139001201,12.01,ARC 20,2015-05-21T18:32:37.000Z,{D67058BB-D1D6-454A-93EE-2400B03801BC},96.6,1137,416,36.6,742,492,66.3,1879,908,48.3
667,001004,13139001004,10.04,ARC 20,2015-05-21T18:32:37.000Z,{697321F5-C484-4BF4-A9EA-03D4FD404077},489.7,212,64,30.2,958,377,39.4,1170,441,37.7
668,001003,13139001003,10.03,ARC 20,2015-05-21T18:32:37.000Z,{D8ACF1AD-AE1D-4CCD-B57F-5CAE3BB81FB5},740.9,341,74,21.7,1573,820,52.1,1914,894,46.7
669,000305,13139000305,3.05,ARC 20,2015-05-21T18:32:37.000Z,{459BE185-7693-42A9-B5AA-75A7493AAE56},91.8,1239,432,34.9,379,167,44.1,1618,599,37
670,000304,13139000304,3.04,ARC 20,2015-05-21T18:32:37.000Z,{F6153DE8-DF68-4980-BE5D-1EEE660D8786},76.5,1038,263,25.3,128,75,58.6,1166,338,29
671,000303,13139000303,3.03,ARC 20,2015-05-21T18:32:37.000Z,{A6C52DBF-9C9B-4053-BD29-70EE6AD30EF3},74.1,623,92,14.8,378,213,56.3,1001,305,30.5
672,000203,13139000203,2.03,ARC 20,2015-05-21T18:32:37.000Z,{25CDF051-67D3-4E82-A1D1-18D401B35A53},39.9,1230,266,21.6,276,73,26.4,1506,339,22.5
673,000204,13139000204,2.04,ARC 20,2015-05-21T18:32:37.000Z,{FD353F4C-374F-4D35-8407-C13DED325C13},27.8,1336,349,26.1,161,96,59.6,1497,445,29.7
674,160100,13255160100,1601,ARC 20,2015-05-21T18:32:37.000Z,{92014C4B-8EAB-44CB-AF67-732AE7E5F70B},11.6,1376,420,30.5,382,164,42.9,1758,584,33.2
675,160200,13255160200,1602,ARC 20,2015-05-21T18:32:37.000Z,{5B790C88-32BD-4CE5-A74E-706DC327C9D2},43.8,1679,447,26.6,488,293,60,2167,740,34.1
676,161000,13255161000,1610,ARC 20,2015-05-21T18:32:37.000Z,{6B8FBD7C-6D4F-46D9-ACAA-B195A3D975F4},13.3,1597,507,31.7,162,77,47.5,1759,584,33.2
677,161200,13255161200,1612,ARC 20,2015-05-21T18:32:37.000Z,{9BC4462F-40F0-4510-819D-6FFB50C6B55A},47.9,2161,446,20.6,911,462,50.7,3072,908,29.6
678,161100,13255161100,1611,ARC 20,2015-05-21T18:32:37.000Z,{E492DA12-061A-44AE-B871-211B14505F4A},89.1,1361,394,28.9,391,178,45.5,1752,572,32.6
679,160900,13255160900,1609,ARC 20,2015-05-21T18:32:37.000Z,{911657A5-2ADA-430C-94BC-732E8B42EF43},-79,468,148,31.6,404,251,62.1,872,399,45.8
680,160800,13255160800,1608,ARC 20,2015-05-21T18:32:37.000Z,{710AA382-0784-4C29-95C8-8E9918A653D2},-115.8,232,49,21.1,1122,663,59.1,1354,712,52.6
681,160700,13255160700,1607,ARC 20,2015-05-21T18:32:37.000Z,{649811C0-5B2B-4677-B501-5EA2BBD98C00},129.6,1280,481,37.6,1032,557,54,2312,1038,44.9
682,160500,13255160500,1605,ARC 20,2015-05-21T18:32:37.000Z,{73A72BE4-F7D6-4157-9814-4F84FE0F1444},125.1,1695,852,50.3,910,578,63.5,2605,1430,54.9
683,160400,13255160400,1604,ARC 20,2015-05-21T18:32:37.000Z,{8F299E54-B0BE-404C-BB15-65C2A22D1A80},-133.3,682,264,38.7,991,586,59.1,1673,850,50.8
684,160300,13255160300,1603,ARC 20,2015-05-21T18:32:37.000Z,{4ADD3D31-8417-43F1-ADA9-2486DA59030A},0.1,565,198,35,484,321,66.3,1049,519,49.5
685,160600,13255160600,1606,ARC 20,2015-05-21T18:32:37.000Z,{DF8CF5B0-BA98-4004-9067-298404D2E8BE},8.6,1183,308,26,200,120,60,1383,428,30.9
686,080102,13097080102,801.02,ARC 10,2015-05-21T18:32:37.000Z,{2D7086E9-12E7-4A06-9F39-21DD8F077E4E},296.1,1112,475,42.7,1658,768,46.3,2770,1243,44.9
687,080602,13097080602,806.02,ARC 10,2015-05-21T18:32:37.000Z,{365C391E-47C5-4A0B-BC06-E34BD7462A1B},145.6,1593,520,32.6,270,203,75.2,1863,723,38.8
688,080508,13097080508,805.08,ARC 10,2015-05-21T18:32:37.000Z,{1C261685-1364-4D5B-B755-C7DF2F11BD83},16.4,989,258,26.1,1208,432,35.8,2197,690,31.4
689,080510,13097080510,805.10,ARC 10,2015-05-21T18:32:37.000Z,{BE24CA97-D9DA-4029-A7A3-D7C94D963164},365.3,2005,729,36.4,301,223,74.1,2306,952,41.3
690,080509,13097080509,805.09,ARC 10,2015-05-21T18:32:37.000Z,{1C7F34FA-11A8-4516-B2E0-60A9368C6D51},338.8,1494,421,28.2,206,68,33,1700,489,28.8
691,170602,13077170602,1706.02,ARC 20,2015-05-21T18:32:37.000Z,{C2284921-D128-43D6-B691-8697ECD28C90},1849.5,2627,738,28.1,453,47,10.4,3080,785,25.5
692,170503,13077170503,1705.03,ARC 20,2015-05-21T18:32:37.000Z,{81473590-C232-424F-BD2D-A9B2B968A8D5},84.1,1546,360,23.3,473,246,52,2019,606,30
693,170501,13077170501,1705.01,ARC 20,2015-05-21T18:32:37.000Z,{040C7E1A-3E10-404C-94E3-D300FEA701AB},31.6,1928,620,32.2,299,68,22.7,2227,688,30.9
694,170406,13077170406,1704.06,ARC 20,2015-05-21T18:32:37.000Z,{FF095C84-7B8F-48DD-9DA5-3700A333EA8D},113.3,1182,253,21.4,74,44,59.5,1256,297,23.6
695,170305,13077170305,1703.05,ARC 20,2015-05-21T18:32:37.000Z,{387AEB2E-86D6-45D8-9A3D-EC2D51D1632A},349.9,1041,348,33.4,2301,1255,54.5,3342,1603,48
696,170601,13077170601,1706.01,ARC 20,2015-05-21T18:32:37.000Z,{EED50897-B32B-498D-9FCA-842CA5D4D967},165.9,1148,271,23.6,1020,440,43.1,2168,711,32.8
697,170603,13077170603,1706.03,ARC 20,2015-05-21T18:32:37.000Z,{27D8850C-3F77-460E-8D47-428285E853E6},75.5,1643,343,20.9,249,108,43.4,1892,451,23.8
698,170502,13077170502,1705.02,ARC 20,2015-05-21T18:32:37.000Z,{F16EB647-BFF0-46FA-BC3A-96EA7FDE0A77},69,1773,516,29.1,195,92,47.2,1968,608,30.9
699,170405,13077170405,1704.05,ARC 20,2015-05-21T18:32:37.000Z,{3AD9DB44-3D78-4A19-B253-1722E380891B},153.8,2277,663,29.1,164,100,61,2441,763,31.3
700,170404,13077170404,1704.04,ARC 20,2015-05-21T18:32:37.000Z,{757303B9-38C0-4FC2-9EB4-49CBBBF99A38},90.3,1985,505,25.4,145,64,44.1,2130,569,26.7
701,170403,13077170403,1704.03,ARC 20,2015-05-21T18:32:37.000Z,{3F49653C-77B2-4BD5-BFD6-5757F8CE2A77},108.8,1075,364,33.9,245,135,55.1,1320,499,37.8
702,170306,13077170306,1703.06,ARC 20,2015-05-21T18:32:37.000Z,{08275D36-9878-4DBF-A0C9-A0918D109DF7},430.1,1771,417,23.5,1379,509,36.9,3150,926,29.4
703,080603,13097080603,806.03,ARC 10,2015-05-21T18:32:37.000Z,{58802128-7438-4122-8850-BDE30346EEB1},316.7,1712,544,31.8,308,174,56.5,2020,718,35.5
704,080511,13097080511,805.11,ARC 10,2015-05-21T18:32:37.000Z,{47A381A1-B79C-41E9-A709-E95F3339E10C},291.3,2494,753,30.2,403,205,50.9,2897,958,33.1
705,080304,13097080304,803.04,ARC 10,2015-05-21T18:32:37.000Z,{9E576A77-4732-4F2D-AB16-D374122AA233},229,856,209,24.4,1140,671,58.9,1996,880,44.1
706,080404,13097080404,804.04,ARC 10,2015-05-21T18:32:37.000Z,{EB78C845-8EB4-4EDF-89DD-5421B1A89121},190.8,2198,464,21.1,419,226,53.9,2617,690,26.4
707,080303,13097080303,803.03,ARC 10,2015-05-21T18:32:37.000Z,{7A5F11C7-4440-462D-B64A-61352A220833},-72,603,140,23.2,548,316,57.7,1151,456,39.6
708,080403,13097080403,804.03,ARC 10,2015-05-21T18:32:37.000Z,{1A4377CC-0EE6-431E-92DE-86BAC0FFA57C},139.6,1461,370,25.3,181,158,87.3,1642,528,32.2
709,080103,13097080103,801.03,ARC 10,2015-05-21T18:32:37.000Z,{B0A01207-3D23-4446-ACC9-735E3977A174},60.3,768,59,7.7,2222,1317,59.3,2990,1376,46
710,080604,13097080604,806.04,ARC 10,2015-05-21T18:32:37.000Z,{DA998404-55AB-4C21-8CE8-1495F6C3A665},331.2,2332,849,36.4,427,204,47.8,2759,1053,38.2
711,170304,13077170304,1703.04,ARC 20,2015-05-21T18:32:37.000Z,{890066DA-B3C7-4A7D-803D-50E0FED7FA74},159.4,1848,405,21.9,460,276,60,2308,681,29.5
712,170303,13077170303,1703.03,ARC 20,2015-05-21T18:32:37.000Z,{0D1D61FF-5198-47E7-ADE5-398DC1E6833E},87.2,1722,358,20.8,35,0,0,1757,358,20.4
713,170802,13077170802,1708.02,ARC 20,2015-05-21T18:32:37.000Z,{C792BF31-ED43-4CEB-81FB-3448211F71A7},27.6,1362,409,30,285,165,57.9,1647,574,34.9
714,170801,13077170801,1708.01,ARC 20,2015-05-21T18:32:37.000Z,{91E989E7-48D4-4E27-A9C9-E25F19B110B1},40.5,1618,433,26.8,379,166,43.8,1997,599,30
715,170700,13077170700,1707,ARC 20,2015-05-21T18:32:37.000Z,{F518456F-4755-4333-A7B0-C4B07E3B2259},27.2,1499,525,35,986,529,53.7,2485,1054,42.4
716,170402,13077170402,1704.02,ARC 20,2015-05-21T18:32:37.000Z,{8EEA42C0-FA06-44A8-863C-9BE2F6947A6D},144.4,2633,566,21.5,424,175,41.3,3057,741,24.2
717,170200,13077170200,1702,ARC 20,2015-05-21T18:32:37.000Z,{47A4B679-E044-4DFA-A2F2-7158A151917B},41.1,1654,472,28.5,830,550,66.3,2484,1022,41.1
718,170100,13077170100,1701,ARC 20,2015-05-21T18:32:37.000Z,{6EF2E4D9-BDF4-4029-A62A-5C39826A434D},13.2,2286,751,32.9,384,311,81,2670,1062,39.8
719,080201,13097080201,802.01,ARC 10,2015-05-21T18:32:37.000Z,{A9810ACC-F51D-4CCC-B7D8-61D8FDD41A9B},185.1,1685,522,31,221,76,34.4,1906,598,31.4
720,080506,13097080506,805.06,ARC 10,2015-05-21T18:32:37.000Z,{56BA54E3-63F1-477C-BDA4-D65913B50DB0},84.8,1483,450,30.3,354,153,43.2,1837,603,32.8
721,080505,13097080505,805.05,ARC 10,2015-05-21T18:32:37.000Z,{642261D9-381B-4124-981C-EF9A391BC3DA},224.7,900,262,29.1,804,381,47.4,1704,643,37.7
722,080202,13097080202,802.02,ARC 10,2015-05-21T18:32:37.000Z,{3444D8DE-312D-4B9B-8BEE-51D42C402D37},382.2,2191,779,35.6,1189,676,56.9,3380,1455,43
723,080507,13097080507,805.07,ARC 10,2015-05-21T18:32:37.000Z,{964AD017-AA7E-486A-B90C-B817921AE6C6},119.2,947,297,31.4,216,105,48.6,1163,402,34.6
724,080402,13097080402,804.02,ARC 10,2015-05-21T18:32:37.000Z,{A5BFE916-F921-40DE-84B7-DF5F0E47841B},72.1,2528,625,24.7,249,98,39.4,2777,723,26
725,080301,13097080301,803.01,ARC 10,2015-05-21T18:32:37.000Z,{CC4186A0-3672-4855-9E3F-13D7CB115070},536.9,2599,1074,41.3,1159,783,67.6,3758,1857,49.4
726,980000,13089980000,9800,ARC 10,2015-05-21T18:32:37.000Z,{4626C5E8-385E-4E0B-9874-360C6FD5781D},,0,0,,0,0,,0,0,
727,023428,13089023428,234.28,ARC 10,2015-05-21T18:32:37.000Z,{2891D8B2-905A-477A-9E12-C4392ADC0B8E},633,1221,400,32.8,2297,1691,73.6,3518,2091,59.4
728,023426,13089023426,234.26,ARC 10,2015-05-21T18:32:37.000Z,{83C0A371-B7CE-4F81-8E32-7177557B01F7},405.7,1404,573,40.8,124,60,48.4,1528,633,41.4
729,021502,13089021502,215.02,ARC 10,2015-05-21T18:32:37.000Z,{1A17E33D-87F2-486D-AA8D-412B7B0EB1A4},117.1,1131,265,23.4,1269,647,51,2400,912,38
730,022302,13089022302,223.02,ARC 10,2015-05-21T18:32:37.000Z,{B8A8846A-EF25-4FF6-A8E2-562FE1CA3D30},-18.6,974,197,20.2,1006,523,52,1980,720,36.4
731,022007,13089022007,220.07,ARC 10,2015-05-21T18:32:37.000Z,{F8D24B5A-4635-4344-ACC9-104E95B4967D},-450,190,45,23.7,979,558,57,1169,603,51.6
732,021602,13089021602,216.02,ARC 10,2015-05-21T18:32:37.000Z,{16DA8865-3F79-46E5-A2F6-9CA1B3A89499},377.5,1056,260,24.6,758,372,49.1,1814,632,34.8
733,023803,13089023803,238.03,ARC 10,2015-05-21T18:32:37.000Z,{95BF78CB-0827-4930-B84A-758A12F32AA0},-439.5,1428,605,42.4,416,307,73.8,1844,912,49.5
734,022402,13089022402,224.02,ARC 10,2015-05-21T18:32:37.000Z,{89551AAF-0B4A-4CFE-866F-9FAF3E1C7D48},1050.8,146,62,42.5,539,473,87.8,685,535,78.1
735,022700,13089022700,227,ARC 10,2015-05-21T18:32:37.000Z,{6E4963E2-F5E3-4850-A2F3-DACDAFE0960C},392.2,1106,293,26.5,536,347,64.7,1642,640,39
736,022403,13089022403,224.03,ARC 10,2015-05-21T18:32:37.000Z,{4DD5FF16-0188-4289-9137-A8CF8B68F015},15.8,1215,319,26.3,223,75,33.6,1438,394,27.4
737,023425,13089023425,234.25,ARC 10,2015-05-21T18:32:37.000Z,{7CED4F9D-7A7C-420B-B43F-CC8C108B0655},211,1387,448,32.3,479,168,35.1,1866,616,33
738,022204,13089022204,222.04,ARC 10,2015-05-21T18:32:37.000Z,{F8812EEF-56C2-4E0B-9F19-A4C487D788F7},323.8,696,147,21.1,1655,978,59.1,2351,1125,47.9
739,023423,13089023423,234.23,ARC 10,2015-05-21T18:32:37.000Z,{71962953-941F-4C36-8B23-77531C37EE98},372.7,2133,1099,51.5,649,511,78.7,2782,1610,57.9
740,023419,13089023419,234.19,ARC 10,2015-05-21T18:32:37.000Z,{74DA4023-3859-49FB-937F-B603FA06F058},551.5,2323,808,34.8,494,299,60.5,2817,1107,39.3
741,023312,13089023312,233.12,ARC 10,2015-05-21T18:32:37.000Z,{778DC29D-F80A-4235-8DBF-CC24EAED1B32},627.1,2745,1209,44,399,351,88,3144,1560,49.6
742,023311,13089023311,233.11,ARC 10,2015-05-21T18:32:37.000Z,{22E9F951-F20D-4BFC-827E-7C14FD34B791},257.9,1070,302,28.2,269,148,55,1339,450,33.6
743,023213,13089023213,232.13,ARC 10,2015-05-21T18:32:37.000Z,{80EA2B39-A534-4778-B27E-32AA9C8FAB6C},793,1120,562,50.2,741,479,64.6,1861,1041,55.9
744,022301,13089022301,223.01,ARC 10,2015-05-21T18:32:37.000Z,{3F8614A4-99AF-4A3C-8D30-2D34C142F553},274.4,1445,336,23.3,1321,802,60.7,2766,1138,41.1
745,023602,13089023602,236.02,ARC 10,2015-05-21T18:32:37.000Z,{F87D1D4B-B255-4CE9-8F26-E127A5E351B9},-543.6,562,149,26.5,226,169,74.8,788,318,40.4
746,023504,13089023504,235.04,ARC 10,2015-05-21T18:32:37.000Z,{6291CBC5-1B28-4F88-9460-B3E932F2CD23},-1242.5,389,229,58.9,734,527,71.8,1123,756,67.3
747,023411,13089023411,234.11,ARC 10,2015-05-21T18:32:37.000Z,{036B6645-B1C7-464A-80E4-33A607E1BFAE},-717.3,925,306,33.1,351,228,65,1276,534,41.8
748,023410,13089023410,234.10,ARC 10,2015-05-21T18:32:37.000Z,{81979C16-D653-4CBE-BFAB-F266EF309978},-563.1,406,202,49.8,908,605,66.6,1314,807,61.4
749,023501,13089023501,235.01,ARC 10,2015-05-21T18:32:37.000Z,{08E25D5B-D470-49DD-8FC7-5FDDDD89F751},-153.3,508,191,37.6,620,400,64.5,1128,591,52.4
750,023114,13089023114,231.14,ARC 10,2015-05-21T18:32:37.000Z,{AB392DF1-C6DD-4E69-AE32-0C62C31551BE},-283.3,710,305,43,150,78,52,860,383,44.5
751,023112,13089023112,231.12,ARC 10,2015-05-21T18:32:37.000Z,{74305D50-5766-4D86-AF98-BBC021A471D3},-1778,307,118,38.4,1442,922,63.9,1749,1040,59.5
752,021912,13089021912,219.12,ARC 10,2015-05-21T18:32:37.000Z,{65BE6DDD-D5F7-4E41-9B78-CB7D52613496},-25.2,1218,501,41.1,17,17,100,1235,518,41.9
753,021910,13089021910,219.10,ARC 10,2015-05-21T18:32:37.000Z,{58A670DC-7B2F-41C4-91BF-5131B4B525EF},185.7,1239,453,36.6,540,375,69.4,1779,828,46.5
754,021604,13089021604,216.04,ARC 10,2015-05-21T18:32:37.000Z,{20BA42A2-8BEE-4794-B0A2-66E7857C9FC4},231.5,1273,173,13.6,13,0,0,1286,173,13.5
755,021504,13089021504,215.04,ARC 10,2015-05-21T18:32:37.000Z,{A2B434C1-AB3A-49D9-8102-5C7A58F03B91},213.3,945,334,35.3,1435,807,56.2,2380,1141,47.9
756,021503,13089021503,215.03,ARC 10,2015-05-21T18:32:37.000Z,{B5AB0E39-137E-41E7-839C-C686ED6CCF3F},-18.6,582,122,21,947,423,44.7,1529,545,35.6
757,023107,13089023107,231.07,ARC 10,2015-05-21T18:32:37.000Z,{275946D8-6DC9-4C8B-BE34-906076DD5403},-812.1,956,481,50.3,601,499,83,1557,980,62.9
758,023418,13089023418,234.18,ARC 10,2015-05-21T18:32:37.000Z,{81AABE8A-3EBE-4B9F-9984-456FEF0CF1A5},496.4,4391,2022,46,2001,1087,54.3,6392,3109,48.6
759,023101,13089023101,231.01,ARC 10,2015-05-21T18:32:37.000Z,{1A32CD9D-B605-42C3-B684-0C0FDF294B78},-695,1032,390,37.8,502,393,78.3,1534,783,51
760,022401,13089022401,224.01,ARC 10,2015-05-21T18:32:37.000Z,{03100AE7-F741-4413-94C5-CA34286387FF},563,997,314,31.5,854,372,43.6,1851,686,37.1
761,020900,13089020900,209,ARC 10,2015-05-21T18:32:37.000Z,{0E685CBB-D9EB-4323-8BD3-4ABBEF450CE1},-610.6,1649,553,33.5,711,450,63.3,2360,1003,42.5
762,020700,13089020700,207,ARC 10,2015-05-21T18:32:37.000Z,{8A6FBF67-83E1-40D1-8A10-436D4B687159},-1174,517,202,39.1,328,190,57.9,845,392,46.4
763,020600,13089020600,206,ARC 10,2015-05-21T18:32:37.000Z,{CD115C6C-CA29-4632-AA2C-EF5C9E29DBB2},-412.5,383,116,30.3,419,290,69.2,802,406,50.6
764,020500,13089020500,205,ARC 10,2015-05-21T18:32:37.000Z,{568B54BA-8A7C-4710-A5B9-72EA0207DB21},-565.7,633,198,31.3,705,316,44.8,1338,514,38.4
765,021410,13089021410,214.10,ARC 10,2015-05-21T18:32:37.000Z,{268122C4-823B-4475-8103-E2094D137E07},-320.9,599,118,19.7,1042,618,59.3,1641,736,44.9
766,021216,13089021216,212.16,ARC 10,2015-05-21T18:32:37.000Z,{D79A502D-4D56-4A67-AE89-C660603EC2CC},2567.9,1079,422,39.1,2956,1190,40.3,4035,1612,40
767,021911,13089021911,219.11,ARC 10,2015-05-21T18:32:37.000Z,{357E369E-7420-49C6-BDF5-E82775A70BDD},-1460,140,110,78.6,685,467,68.2,825,577,69.9
768,020802,13089020802,208.02,ARC 10,2015-05-21T18:32:37.000Z,{4A6DF131-163E-492C-A6EC-498FD5E208F2},447.3,1022,361,35.3,485,198,40.8,1507,559,37.1
769,021416,13089021416,214.16,ARC 10,2015-05-21T18:32:37.000Z,{91F38104-9F84-4D9E-9B28-20857750F17F},-2486.7,402,85,21.1,548,257,46.9,950,342,36
770,021413,13089021413,214.13,ARC 10,2015-05-21T18:32:37.000Z,{78666FFF-CF96-4664-A027-690D87F157F8},2352.5,282,74,26.2,949,595,62.7,1231,669,54.3
771,021411,13089021411,214.11,ARC 10,2015-05-21T18:32:37.000Z,{774E6A03-3945-47D2-8451-B7D2E2FD275E},736.7,650,138,21.2,1065,252,23.7,1715,390,22.7
772,020400,13089020400,204,ARC 10,2015-05-21T18:32:37.000Z,{1A5388E0-97CB-4F14-91FE-059CF0D1621B},612.5,719,156,21.7,435,119,27.4,1154,275,23.8
773,020300,13089020300,203,ARC 10,2015-05-21T18:32:37.000Z,{2A708BAD-09F1-4221-9F61-09750B5C2C48},452.9,1043,234,22.4,482,152,31.5,1525,386,25.3
774,020100,13089020100,201,ARC 10,2015-05-21T18:32:37.000Z,{0CDA22A2-757A-46BD-8DEF-2DD1B4851C8D},-82.5,554,120,21.7,153,39,25.5,707,159,22.5
775,023802,13089023802,238.02,ARC 10,2015-05-21T18:32:37.000Z,{43CA6863-0C4C-4D9F-B1C1-46BC6DE6A88F},-25.4,510,155,30.4,694,411,59.2,1204,566,47
776,023801,13089023801,238.01,ARC 10,2015-05-21T18:32:37.000Z,{B9E1C8AE-6AF1-4077-813E-E378106B5DCF},-660,980,340,34.7,344,167,48.5,1324,507,38.3
777,023700,13089023700,237,ARC 10,2015-05-21T18:32:37.000Z,{BE3B0DCC-B043-4379-B6FA-CA2896149764},-349.4,959,291,30.3,1002,698,69.7,1961,989,50.4
778,023506,13089023506,235.06,ARC 10,2015-05-21T18:32:37.000Z,{592A8761-CDD4-4CEE-91BC-651F1804E60D},-751,1555,498,32,438,284,64.8,1993,782,39.2
779,023505,13089023505,235.05,ARC 10,2015-05-21T18:32:37.000Z,{2392FADB-3C6A-4C73-9D33-9D1933F234AF},-751.3,651,246,37.8,248,200,80.6,899,446,49.6
780,023427,13089023427,234.27,ARC 10,2015-05-21T18:32:37.000Z,{695A811F-4DF3-4B68-9515-6C4B7D8AC7CB},-261.7,811,332,40.9,256,185,72.3,1067,517,48.5
781,023424,13089023424,234.24,ARC 10,2015-05-21T18:32:37.000Z,{95D40031-D531-46DB-AF1F-490EFAE62075},538.1,1333,559,41.9,266,194,72.9,1599,753,47.1
782,023422,13089023422,234.22,ARC 10,2015-05-21T18:32:37.000Z,{C42E643E-2B6E-48BE-A0F6-8C67F2BF7EA5},288,1422,541,38,287,185,64.5,1709,726,42.5
783,023421,13089023421,234.21,ARC 10,2015-05-21T18:32:37.000Z,{40699E6D-F5C8-4393-A2E1-735E03C05A9C},955,1437,650,45.2,1490,734,49.3,2927,1384,47.3
784,023315,13089023315,233.15,ARC 10,2015-05-21T18:32:37.000Z,{BE123F06-0ECD-457C-8D1C-2EE345CED9A7},266.4,1578,600,38,100,84,84,1678,684,40.8
785,023314,13089023314,233.14,ARC 10,2015-05-21T18:32:37.000Z,{0C92159F-C069-4A49-80D6-12F0AB820BEB},-519.5,1369,493,36,614,417,67.9,1983,910,45.9
786,023115,13089023115,231.15,ARC 10,2015-05-21T18:32:37.000Z,{92BD1D67-886E-40F7-882D-80CF4B55C8C4},2356.7,0,0,,0,0,,0,0,
787,023413,13089023413,234.13,ARC 10,2015-05-21T18:32:37.000Z,{6A119BEB-D844-42E3-9EE2-209C4A5649BF},-381.9,1106,465,42,184,72,39.1,1290,537,41.6
788,023414,13089023414,234.14,ARC 10,2015-05-21T18:32:37.000Z,{CB852D32-9CD7-48A7-96C7-E038E3B97C7F},-411.1,1506,680,45.2,697,357,51.2,2203,1037,47.1
789,023206,13089023206,232.06,ARC 10,2015-05-21T18:32:37.000Z,{786FE80A-1E83-401D-AA41-00C5F804CA64},-172.9,1750,723,41.3,713,542,76,2463,1265,51.4
790,021907,13089021907,219.07,ARC 10,2015-05-21T18:32:37.000Z,{63EC97B9-B443-47F9-8B87-39CBEA2C5D0B},103.8,2423,431,17.8,982,656,66.8,3405,1087,31.9
791,023204,13089023204,232.04,ARC 10,2015-05-21T18:32:37.000Z,{59B2247C-47B1-4F53-88B7-8BF68C15197B},-113.1,1932,651,33.7,417,257,61.6,2349,908,38.7
792,023113,13089023113,231.13,ARC 10,2015-05-21T18:32:37.000Z,{3A7BB6F4-A382-4FCC-BF48-7892F0DADA3E},-1697.5,366,83,22.7,1080,782,72.4,1446,865,59.8
793,022010,13089022010,220.10,ARC 10,2015-05-21T18:32:37.000Z,{5D055A5C-A5F3-4C75-907E-6FA33958349D},182,337,100,29.7,359,245,68.2,696,345,49.6
794,023111,13089023111,231.11,ARC 10,2015-05-21T18:32:37.000Z,{EECBB4FA-2995-4447-89E1-0D397F59CF40},-176.7,449,133,29.6,124,93,75,573,226,39.4
795,021814,13089021814,218.14,ARC 10,2015-05-21T18:32:37.000Z,{A283FD8A-8BDC-4A75-9BA5-D121E372D31A},-40,803,243,30.3,1663,1019,61.3,2466,1262,51.2
796,021409,13089021409,214.09,ARC 10,2015-05-21T18:32:37.000Z,{F5333EE6-D2FF-4B7D-AD56-494C730A8966},-1357.5,133,39,29.3,719,312,43.4,852,351,41.2
797,021218,13089021218,212.18,ARC 10,2015-05-21T18:32:37.000Z,{F7A4B57B-6387-4832-9CC0-88C5D0FB5D70},1124.5,1149,265,23.1,1862,798,42.9,3011,1063,35.3
798,023507,13089023507,235.07,ARC 10,2015-05-21T18:32:37.000Z,{E8401A70-9B67-4F74-8023-3F8477285C38},-386.4,1034,428,41.4,399,221,55.4,1433,649,45.3
799,023412,13089023412,234.12,ARC 10,2015-05-21T18:32:37.000Z,{302D672E-9943-420D-A348-D78C6FBA7D1F},-276.8,1477,535,36.2,573,276,48.2,2050,811,39.6
800,023416,13089023416,234.16,ARC 10,2015-05-21T18:32:37.000Z,{D0F0C08C-E084-4612-83B5-831BCCBCB7AE},317.3,1689,767,45.4,734,376,51.2,2423,1143,47.2
801,023102,13089023102,231.02,ARC 10,2015-05-21T18:32:37.000Z,{A7D706B9-87DA-4106-A172-D41CF9B3DF28},-410,667,153,22.9,685,472,68.9,1352,625,46.2
802,023000,13089023000,230,ARC 10,2015-05-21T18:32:37.000Z,{DC77CA73-832D-45F6-A8F0-83A0BC5D1BD5},-54.3,641,174,27.1,329,211,64.1,970,385,39.7
803,021906,13089021906,219.06,ARC 10,2015-05-21T18:32:37.000Z,{10254913-40C3-4EAB-BC66-07BB23D09958},-615.8,1108,447,40.3,724,487,67.3,1832,934,51
804,021217,13089021217,212.17,ARC 10,2015-05-21T18:32:37.000Z,{A1A49B49-F3CB-4606-A3B1-20320B4E615A},-768.3,625,174,27.8,313,123,39.3,938,297,31.7
805,021215,13089021215,212.15,ARC 10,2015-05-21T18:32:37.000Z,{E1413EBB-43FF-4C95-91B7-4FFD03969EEF},1816.9,753,245,32.5,1801,549,30.5,2554,794,31.1
806,021414,13089021414,214.14,ARC 10,2015-05-21T18:32:37.000Z,{0A888512-AE13-47C4-A282-AB491486340C},-1117.5,89,0,0,1336,660,49.4,1425,660,46.3
807,021101,13089021101,211.01,ARC 10,2015-05-21T18:32:37.000Z,{2909E2E3-BB10-423F-B80B-846554472E73},583.1,1060,350,33,240,54,22.5,1300,404,31.1
808,023316,13089023316,233.16,ARC 10,2015-05-21T18:32:37.000Z,{0DD6B99A-24B4-482A-8786-9A4DDDAC6C27},277.4,2346,891,38,556,282,50.7,2902,1173,40.4
809,023313,13089023313,233.13,ARC 10,2015-05-21T18:32:37.000Z,{92F83401-50F6-404C-BD09-C518FA3E63D8},-11.6,1100,457,41.5,280,234,83.6,1380,691,50.1
810,022900,13089022900,229,ARC 10,2015-05-21T18:32:37.000Z,{A0FC9A7F-9D80-428B-A0C1-3661F33B6853},-465.3,1076,353,32.8,371,208,56.1,1447,561,38.8
811,022800,13089022800,228,ARC 10,2015-05-21T18:32:37.000Z,{9709DD8A-062F-486F-BD48-D8DB5BC4262C},-90,919,243,26.4,351,140,39.9,1270,383,30.2
812,022600,13089022600,226,ARC 10,2015-05-21T18:32:37.000Z,{B77C5908-AB5B-4ECA-B87E-85BF939F44DF},595,1756,583,33.2,1124,574,51.1,2880,1157,40.2
813,022500,13089022500,225,ARC 10,2015-05-21T18:32:37.000Z,{6D3D8734-2B89-4882-B1E0-C3F08453FB89},151.8,1355,377,27.8,983,561,57.1,2338,938,40.1
814,022100,13089022100,221,ARC 10,2015-05-21T18:32:37.000Z,{F8DA1C95-4A34-4AC3-A720-E7F920E8D1F9},-21.5,679,217,32,663,342,51.6,1342,559,41.7
815,022005,13089022005,220.05,ARC 10,2015-05-21T18:32:37.000Z,{0E63282C-3489-4002-8C11-F9AE390FD2E0},-692.3,584,247,42.3,830,447,53.9,1414,694,49.1
816,023214,13089023214,232.14,ARC 10,2015-05-21T18:32:37.000Z,{8CDA974D-D9A6-4BED-B669-7C62A3BC4DCD},188.1,771,310,40.2,1046,528,50.5,1817,838,46.1
817,022203,13089022203,222.03,ARC 10,2015-05-21T18:32:37.000Z,{534F8132-895C-417D-836C-815B8C15FA91},482.7,238,124,52.1,611,282,46.2,849,406,47.8
818,022009,13089022009,220.09,ARC 10,2015-05-21T18:32:37.000Z,{0064168E-BAF8-40EF-A15C-5B8AF691B5BC},-1125.7,226,127,56.2,1835,1020,55.6,2061,1147,55.7
819,021913,13089021913,219.13,ARC 10,2015-05-21T18:32:37.000Z,{5EF9936D-3395-4D00-A412-A12A259B1862},-829.2,179,55,30.7,1459,665,45.6,1638,720,44
820,021813,13089021813,218.13,ARC 10,2015-05-21T18:32:37.000Z,{D89076B6-E301-412A-B57D-58340AACF9B2},1995,0,0,,937,636,67.9,937,636,67.9
821,021605,13089021605,216.05,ARC 10,2015-05-21T18:32:37.000Z,{3760BAB3-AE28-4ECE-A858-744FDF49BC6B},277.1,958,316,33,1329,814,61.2,2287,1130,49.4
822,021308,13089021308,213.08,ARC 10,2015-05-21T18:32:37.000Z,{EE2388E9-BFFF-4632-85C0-1904D28B5011},-723,615,254,41.3,593,300,50.6,1208,554,45.9
823,022004,13089022004,220.04,ARC 10,2015-05-21T18:32:37.000Z,{5AD816C4-A074-4BBC-82C1-A681B6D2E9D0},-245,1219,445,36.5,334,201,60.2,1553,646,41.6
824,022008,13089022008,220.08,ARC 10,2015-05-21T18:32:37.000Z,{367F8641-45EE-47AC-B17C-155256E52E26},-393.3,562,238,42.3,1806,1053,58.3,2368,1291,54.5
825,021909,13089021909,219.09,ARC 10,2015-05-21T18:32:37.000Z,{DB519083-CFDB-420D-B2B3-BFA4356F3194},-1130,896,366,40.8,1281,737,57.5,2177,1103,50.7
826,022001,13089022001,220.01,ARC 10,2015-05-21T18:32:37.000Z,{410B01FE-5F7A-4064-8B00-7146EEB3E0C9},245.9,1402,413,29.5,528,287,54.4,1930,700,36.3
827,023108,13089023108,231.08,ARC 10,2015-05-21T18:32:37.000Z,{79DDAD5D-F3CE-4328-B4EB-09861F0C17DD},-641.4,629,195,31,926,675,72.9,1555,870,55.9
828,020200,13089020200,202,ARC 10,2015-05-21T18:32:37.000Z,{CE881546-26E5-4F3A-ADA5-2E67C974F9E6},-431.7,534,193,36.1,423,138,32.6,957,331,34.6
829,021306,13089021306,213.06,ARC 10,2015-05-21T18:32:37.000Z,{A28312C7-DF51-4370-99E7-B1BA4E88F6F6},-309.5,458,206,45,1295,596,46,1753,802,45.8
830,021305,13089021305,213.05,ARC 10,2015-05-21T18:32:37.000Z,{EC33CE0B-8045-4335-97FB-7763EC05C80D},-35,522,163,31.2,972,596,61.3,1494,759,50.8
831,021417,13089021417,214.17,ARC 10,2015-05-21T18:32:37.000Z,{C3D5ECC6-3E09-4DE3-82F4-D21F8D141B8C},358.6,271,79,29.2,1798,1049,58.3,2069,1128,54.5
832,021415,13089021415,214.15,ARC 10,2015-05-21T18:32:37.000Z,{4EDF1D60-560E-4479-BDB9-CE9F80323E26},913.8,817,259,31.7,864,361,41.8,1681,620,36.9
833,021102,13089021102,211.02,ARC 10,2015-05-21T18:32:37.000Z,{C95B5857-A29A-4010-9400-1E0AC07B59F5},-530.7,1160,330,28.4,1215,325,26.7,2375,655,27.6
834,021307,13089021307,213.07,ARC 10,2015-05-21T18:32:37.000Z,{BD09C200-64FE-4C83-8187-645E7E37A2E5},-10,686,319,46.5,545,350,64.2,1231,669,54.3
835,023601,13089023601,236.01,ARC 10,2015-05-21T18:32:37.000Z,{B3D6BA15-8954-48DC-918D-CAE2F4632EB1},-865.7,683,266,38.9,261,77,29.5,944,343,36.3
836,021412,13089021412,214.12,ARC 10,2015-05-21T18:32:37.000Z,{861A3966-73F5-425A-B1D6-7A3DA358AC4A},80,986,256,26,354,64,18.1,1340,320,23.9
837,023208,13089023208,232.08,ARC 10,2015-05-21T18:32:37.000Z,{69D87B76-3515-4552-AF1C-48D60AE6AB2C},-531.7,1364,636,46.6,710,393,55.4,2074,1029,49.6
838,023310,13089023310,233.10,ARC 10,2015-05-21T18:32:37.000Z,{C23908EE-2920-4D5D-9C40-8A8FA431890D},663.7,946,459,48.5,2540,1728,68,3486,2187,62.7
839,020801,13089020801,208.01,ARC 10,2015-05-21T18:32:37.000Z,{029FC03A-C8D5-4520-AE0F-B8272F92EE35},-532,885,346,39.1,140,56,40,1025,402,39.2
840,021812,13089021812,218.12,ARC 10,2015-05-21T18:32:37.000Z,{E2D9EF1A-2948-4FC5-9B3E-3A34ADAF35F1},187.5,588,129,21.9,300,195,65,888,324,36.5
841,021214,13089021214,212.14,ARC 10,2015-05-21T18:32:37.000Z,{852C359A-24F8-460B-92F1-D46079B26C9D},112.7,1758,417,23.7,191,121,63.4,1949,538,27.6
842,021810,13089021810,218.10,ARC 10,2015-05-21T18:32:37.000Z,{356701F3-1D73-4BE4-9C0E-A249F694FE7A},336,1653,448,27.1,728,269,37,2381,717,30.1
843,021809,13089021809,218.09,ARC 10,2015-05-21T18:32:37.000Z,{70F096F5-2DB3-4026-98AF-E8D01C5EDB19},65.3,2302,471,20.5,166,84,50.6,2468,555,22.5
844,021808,13089021808,218.08,ARC 10,2015-05-21T18:32:37.000Z,{2B2224F9-677C-49D0-96F4-2AF24021E581},37.5,1301,298,22.9,501,275,54.9,1802,573,31.8
845,021806,13089021806,218.06,ARC 10,2015-05-21T18:32:37.000Z,{52B5C757-06FD-46F1-ADF6-131C8D37F848},116.3,989,313,31.6,1319,775,58.8,2308,1088,47.1
846,021805,13089021805,218.05,ARC 10,2015-05-21T18:32:37.000Z,{02C4200B-CE5D-4652-AD86-731C8CFC495C},-146.3,1697,558,32.9,622,402,64.6,2319,960,41.4
847,021704,13089021704,217.04,ARC 10,2015-05-21T18:32:37.000Z,{5CD8613F-8944-4CED-85BD-B6FBB32DB289},108.6,1448,324,22.4,556,257,46.2,2004,581,29
848,021703,13089021703,217.03,ARC 10,2015-05-21T18:32:37.000Z,{EC725C2D-C8CD-4F82-A99B-0C6EA5337BC6},63.5,1601,299,18.7,113,7,6.2,1714,306,17.9
849,021705,13089021705,217.05,ARC 10,2015-05-21T18:32:37.000Z,{8ADE40F3-06F8-4166-A2B0-401F6F9943F9},26.5,814,280,34.4,1416,663,46.8,2230,943,42.3
850,021908,13089021908,219.08,ARC 10,2015-05-21T18:32:37.000Z,{BA657F2C-D1AE-49A7-A1B8-6C6C1A16218C},259.2,548,98,17.9,1363,767,56.3,1911,865,45.3
851,023309,13089023309,233.09,ARC 10,2015-05-21T18:32:37.000Z,{5928EC10-38EA-48D9-A28C-CB60A0F28ACB},1040.5,2121,798,37.6,1145,798,69.7,3266,1596,48.9
852,023211,13089023211,232.11,ARC 10,2015-05-21T18:32:37.000Z,{B89F0172-B453-4A3D-AE1E-4EDC8CFD7DC1},-811,591,159,26.9,508,222,43.7,1099,381,34.7
853,023212,13089023212,232.12,ARC 10,2015-05-21T18:32:37.000Z,{E3C9B5BE-609C-4F1B-A336-8FB16B5135D2},-230,807,229,28.4,368,275,74.7,1175,504,42.9
854,023306,13089023306,233.06,ARC 10,2015-05-21T18:32:37.000Z,{0A914A33-023A-42D7-A8D6-EBA144EA1216},332.3,1951,794,40.7,382,190,49.7,2333,984,42.2
855,023303,13089023303,233.03,ARC 10,2015-05-21T18:32:37.000Z,{A827AC50-FE0E-4D09-BCF9-B55883493BCA},249.7,1329,555,41.8,745,510,68.5,2074,1065,51.4
856,021706,13089021706,217.06,ARC 10,2015-05-21T18:32:37.000Z,{5BAC796F-7638-4A1E-B5A4-BC311CE5EFC1},327,1761,381,21.6,1010,537,53.2,2771,918,33.1
857,021211,13089021211,212.11,ARC 10,2015-05-21T18:32:37.000Z,{EFCB9392-490C-45C5-9E99-870A2E8765F1},25.8,1710,403,23.6,83,20,24.1,1793,423,23.6
858,021210,13089021210,212.10,ARC 10,2015-05-21T18:32:37.000Z,{C6D0F5C4-5AA7-4DE2-AE15-46F0E41948A1},136,1813,377,20.8,133,59,44.4,1946,436,22.4
859,021213,13089021213,212.13,ARC 10,2015-05-21T18:32:37.000Z,{38BD51A9-F8D9-42EE-A121-3D64EA9DF274},170,1143,288,25.2,30,12,40,1173,300,25.6
860,021303,13089021303,213.03,ARC 10,2015-05-21T18:32:37.000Z,{18A6FBFD-0C4B-4934-BC10-F0D3BB9005EF},200,694,335,48.3,993,580,58.4,1687,915,54.2
861,021301,13089021301,213.01,ARC 10,2015-05-21T18:32:37.000Z,{D9DAD196-422B-4C01-83E7-92B335BBE8B9},191.4,266,117,44,1085,567,52.3,1351,684,50.6
862,021209,13089021209,212.09,ARC 10,2015-05-21T18:32:37.000Z,{93F3312A-0C87-4F8E-B8D0-BFBF4913F18B},-9.5,1172,216,18.4,1315,432,32.9,2487,648,26.1
863,021405,13089021405,214.05,ARC 10,2015-05-21T18:32:37.000Z,{95974748-1594-4779-BE51-50FEBDC80E3C},651.1,1206,288,23.9,402,136,33.8,1608,424,26.4
864,021208,13089021208,212.08,ARC 10,2015-05-21T18:32:37.000Z,{37193E58-FCE1-4EF2-B68A-4056D65790F4},616.4,980,386,39.4,489,216,44.2,1469,602,41
865,021204,13089021204,212.04,ARC 10,2015-05-21T18:32:37.000Z,{2CA2D010-8051-4B94-B038-5B5B2EA7FEF3},-617.8,113,27,23.9,914,434,47.5,1027,461,44.9
866,021202,13089021202,212.02,ARC 10,2015-05-21T18:32:37.000Z,{61F8C36F-A153-4404-B538-9F5E1A2E3361},459.6,2219,531,23.9,694,285,41.1,2913,816,28
867,023210,13089023210,232.10,ARC 10,2015-05-21T18:32:37.000Z,{4103290B-7007-4462-BC16-B901D2F4D634},-448.8,1217,533,43.8,1297,691,53.3,2514,1224,48.7
868,023209,13089023209,232.09,ARC 10,2015-05-21T18:32:37.000Z,{1A01A565-AD0B-48F6-BD75-A204FC6D6D8A},-452.8,1321,293,22.2,277,187,67.5,1598,480,30
869,023603,13089023603,236.03,ARC 10,2015-05-21T18:32:37.000Z,{E2610CA0-4512-4384-BE4F-062570851553},-865.5,776,307,39.6,406,280,69,1182,587,49.7
870,021603,13089021603,216.03,ARC 10,2015-05-21T18:32:37.000Z,{AF3C542C-1A4F-4AB0-A45C-3749EB3EC85D},-252,1026,289,28.2,1719,839,48.8,2745,1128,41.1
871,090905,13057090905,909.05,ARC 10,2015-05-21T18:32:37.000Z,{F1CB8D43-1117-4C26-9C71-A1D05C4458C5},674.4,1072,378,35.3,654,278,42.5,1726,656,38
872,090904,13057090904,909.04,ARC 10,2015-05-21T18:32:37.000Z,{ADBA85D8-B7FE-4942-8FB5-8A26492B9A63},443.1,2081,700,33.6,623,351,56.3,2704,1051,38.9
873,091007,13057091007,910.07,ARC 10,2015-05-21T18:32:37.000Z,{420E39CE-B22E-45C4-8603-39C4BCEBD831},110.3,2032,579,28.5,153,58,37.9,2185,637,29.2
874,090803,13057090803,908.03,ARC 10,2015-05-21T18:32:37.000Z,{2D1256F1-7581-43F0-9188-7059E2E66184},509.5,3109,906,29.1,103,85,82.5,3212,991,30.9
875,090804,13057090804,908.04,ARC 10,2015-05-21T18:32:37.000Z,{F2870E8B-795E-4E58-88F0-068D21ED7763},244,2568,425,16.5,298,130,43.6,2866,555,19.4
876,091008,13057091008,910.08,ARC 10,2015-05-21T18:32:37.000Z,{D100DB39-98A7-4185-91B1-C098865C224A},600.8,2513,633,25.2,461,168,36.4,2974,801,26.9
877,090802,13057090802,908.02,ARC 10,2015-05-21T18:32:37.000Z,{F088A786-01D4-4110-B07B-E653A38F0F19},74.4,2210,664,30,121,47,38.8,2331,711,30.5
878,090501,13057090501,905.01,ARC 10,2015-05-21T18:32:37.000Z,{5A9B9229-B9E0-4FD3-9BA7-E8A0D2741994},66.4,1917,551,28.7,154,66,42.9,2071,617,29.8
879,090902,13057090902,909.02,ARC 10,2015-05-21T18:32:37.000Z,{B07C1FE1-D346-470A-A94E-52A7EA0408BE},814.2,4473,1343,30,813,447,55,5286,1790,33.9
880,091001,13057091001,910.01,ARC 10,2015-05-21T18:32:37.000Z,{89D98AAC-FA0F-4A8D-B402-555808903384},394.9,738,155,21,838,441,52.6,1576,596,37.8
881,091003,13057091003,910.03,ARC 10,2015-05-21T18:32:37.000Z,{B086BCB6-221C-4994-A8E7-9D1E9F10C9EC},321.8,1360,487,35.8,1275,594,46.6,2635,1081,41
882,091102,13057091102,911.02,ARC 10,2015-05-21T18:32:37.000Z,{39333D5C-311E-418F-B82F-8A971D20818E},303.5,2184,523,23.9,644,313,48.6,2828,836,29.6
883,091101,13057091101,911.01,ARC 10,2015-05-21T18:32:37.000Z,{C513DBE6-B0D5-4FDF-A652-27C3A68B767E},16.3,1611,531,33,352,137,38.9,1963,668,34
884,091103,13057091103,911.03,ARC 10,2015-05-21T18:32:37.000Z,{05866718-DECB-4C82-8072-849AE73A500E},81.9,2386,548,23,289,87,30.1,2675,635,23.7
885,090701,13057090701,907.01,ARC 10,2015-05-21T18:32:37.000Z,{6AF34CB8-9B4F-4CB2-9F8D-0D7FB3525CAE},798.2,5432,1537,28.3,1161,462,39.8,6593,1999,30.3
886,110601,13297110601,1106.01,ARC 20,2015-05-21T18:32:37.000Z,{26F5433D-9940-427D-BA51-A45281390793},100.1,1519,476,31.3,40,0,0,1559,476,30.5
887,110507,13297110507,1105.07,ARC 20,2015-05-21T18:32:37.000Z,{0EFCAC50-2775-447C-AC34-9194567900BF},271.5,1970,576,29.2,394,269,68.3,2364,845,35.7
888,110506,13297110506,1105.06,ARC 20,2015-05-21T18:32:37.000Z,{74B898DB-A356-4A7C-AA7F-A9C9CF2B80EF},134.1,1627,503,30.9,301,154,51.2,1928,657,34.1
889,110603,13297110603,1106.03,ARC 20,2015-05-21T18:32:37.000Z,{64806C0F-C5E1-4073-B354-6DCC8013E9D3},80.3,1264,449,35.5,277,199,71.8,1541,648,42.1
890,110602,13297110602,1106.02,ARC 20,2015-05-21T18:32:37.000Z,{04F958F4-6523-4149-964D-77B36BACA5B2},42.8,1468,480,32.7,209,101,48.3,1677,581,34.6
891,110504,13297110504,1105.04,ARC 20,2015-05-21T18:32:37.000Z,{6455B019-5329-4299-88ED-C0E4D315B025},79.2,1185,304,25.7,574,441,76.8,1759,745,42.4
892,110508,13297110508,1105.08,ARC 20,2015-05-21T18:32:37.000Z,{2484D597-1E05-48BA-B4AC-22F00D0FBDBC},166.6,1403,390,27.8,187,104,55.6,1590,494,31.1
893,110503,13297110503,1105.03,ARC 20,2015-05-21T18:32:37.000Z,{19875675-0F62-4835-A952-4B4C14EDF122},177.9,920,214,23.3,153,129,84.3,1073,343,32
894,110505,13297110505,1105.05,ARC 20,2015-05-21T18:32:37.000Z,{568824DF-4374-4482-8582-2F511EBEE060},183.2,1084,291,26.8,135,21,15.6,1219,312,25.6
895,110800,13297110800,1108,ARC 20,2015-05-21T18:32:37.000Z,{93CD6268-668D-4F80-A272-BA23361AF622},21.8,1646,311,18.9,641,345,53.8,2287,656,28.7
896,110700,13297110700,1107,ARC 20,2015-05-21T18:32:37.000Z,{771BC1D7-2A8D-48FF-B112-102DA05BFCB7},83.1,1449,499,34.4,795,319,40.1,2244,818,36.5
897,110400,13297110400,1104,ARC 20,2015-05-21T18:32:37.000Z,{DED6147B-64A2-4025-8B69-09BE39670401},25.7,1224,439,35.9,1065,800,75.1,2289,1239,54.1
898,110300,13297110300,1103,ARC 20,2015-05-21T18:32:37.000Z,{64B333BD-65E0-4DEA-9750-91BF2779EB8A},99.8,1200,269,22.4,1328,714,53.8,2528,983,38.9
899,110200,13297110200,1102,ARC 20,2015-05-21T18:32:37.000Z,{4020E8EE-93DD-4628-A5FE-5F5D8307F25C},20.1,1253,295,23.5,248,115,46.4,1501,410,27.3
900,110100,13297110100,1101,ARC 20,2015-05-21T18:32:37.000Z,{77FB6299-E8B1-403F-B01F-19A478B81F5A},69.4,2740,876,32,383,151,39.4,3123,1027,32.9
901,091005,13057091005,910.05,ARC 10,2015-05-21T18:32:37.000Z,{1214BE21-7417-467C-B740-0955C5BE1531},127.9,1774,380,21.4,927,477,51.5,2701,857,31.7
902,091006,13057091006,910.06,ARC 10,2015-05-21T18:32:37.000Z,{8E8B817E-C986-4395-AE2E-D9ABCB3EF3EC},72.1,1519,390,25.7,148,48,32.4,1667,438,26.3
903,090400,13057090400,904,ARC 10,2015-05-21T18:32:37.000Z,{965B59D2-1ECA-471D-A1A0-9FE0FEAFBC42},238.8,1438,439,30.5,1870,1122,60,3308,1561,47.2
904,090601,13057090601,906.01,ARC 10,2015-05-21T18:32:37.000Z,{C03D1302-0875-48B8-96CB-A4BBD1B93A6B},249.9,1197,352,29.4,860,469,54.5,2057,821,39.9
905,090901,13057090901,909.01,ARC 10,2015-05-21T18:32:37.000Z,{53C37A75-E1EF-42CE-9AE1-7EE96C9D6A75},126.4,2234,546,24.4,309,90,29.1,2543,636,25
906,090602,13057090602,906.02,ARC 10,2015-05-21T18:32:37.000Z,{EF7AEA79-D76A-4B48-8545-D4803A05762D},202.6,2172,648,29.8,546,341,62.5,2718,989,36.4
907,090200,13057090200,902,ARC 10,2015-05-21T18:32:37.000Z,{6E279DFB-92B3-4AB9-B44A-4A21C0AA9F39},24.5,2210,613,27.7,401,229,57.1,2611,842,32.2
908,090702,13057090702,907.02,ARC 10,2015-05-21T18:32:38.000Z,{D6E147BC-63FC-4993-8334-41273DD13D76},217.3,2089,575,27.5,708,417,58.9,2797,992,35.5
909,090502,13057090502,905.02,ARC 10,2015-05-21T18:32:38.000Z,{F2B4BA83-A003-4826-9AEC-9FFEB26517DB},196.7,3802,1456,38.3,220,78,35.5,4022,1534,38.1
910,090100,13057090100,901,ARC 10,2015-05-21T18:32:38.000Z,{6F62ADF4-A043-4BAE-BA1A-3D4E7468707E},44.5,2439,734,30.1,511,283,55.4,2950,1017,34.5
911,090300,13057090300,903,ARC 10,2015-05-21T18:32:38.000Z,{363EA24A-C9AA-457F-B217-43BF259A7468},181.7,3315,869,26.2,590,368,62.4,3905,1237,31.7
912,180206,13013180206,1802.06,ARC 20,2015-05-21T18:32:38.000Z,{97B00800-76D4-4233-B0AD-480FDB32837D},158.5,557,161,28.9,407,201,49.4,964,362,37.6
913,180205,13013180205,1802.05,ARC 20,2015-05-21T18:32:38.000Z,{F23C7AD2-2AC8-42B3-BD3A-0C9A3C24B98A},93.7,674,153,22.7,631,343,54.4,1305,496,38
914,180402,13013180402,1804.02,ARC 20,2015-05-21T18:32:38.000Z,{1FE4C6E1-709E-4419-9DB3-2A987459250B},139.2,1437,258,18,371,230,62,1808,488,27
915,180303,13013180303,1803.03,ARC 20,2015-05-21T18:32:38.000Z,{3943CA73-A538-4F82-9D1B-8A6F8471B62E},124.6,1077,325,30.2,161,87,54,1238,412,33.3
916,180106,13013180106,1801.06,ARC 20,2015-05-21T18:32:38.000Z,{67CC7ABC-EE28-4E46-9411-95C84F772D91},-40.4,793,219,27.6,159,112,70.4,952,331,34.8
917,180103,13013180103,1801.03,ARC 20,2015-05-21T18:32:38.000Z,{8FAA4587-7DB6-4F4A-9066-BC0B83C53770},256.1,1297,337,26,74,11,14.9,1371,348,25.4
918,180401,13013180401,1804.01,ARC 20,2015-05-21T18:32:38.000Z,{F76823E9-9A20-4751-BCDD-BC1684D7AF6A},152.5,1584,486,30.7,323,61,18.9,1907,547,28.7
919,180203,13013180203,1802.03,ARC 20,2015-05-21T18:32:38.000Z,{801092A5-6DBC-48D2-A44D-356DC8B20324},188.2,477,152,31.9,584,263,45,1061,415,39.1
920,180503,13013180503,1805.03,ARC 20,2015-05-21T18:32:38.000Z,{637CD78C-4C5A-4829-B6B8-2646211583EE},335.8,1505,453,30.1,149,78,52.3,1654,531,32.1
921,180502,13013180502,1805.02,ARC 20,2015-05-21T18:32:38.000Z,{B0D1591E-39ED-4D40-9816-E854AF888D4D},100.7,1417,500,35.3,212,157,74.1,1629,657,40.3
922,180204,13013180204,1802.04,ARC 20,2015-05-21T18:32:38.000Z,{00426BAE-66BF-4F3E-B8B3-326EC111274A},88.4,417,180,43.2,344,195,56.7,761,375,49.3
923,180501,13013180501,1805.01,ARC 20,2015-05-21T18:32:38.000Z,{BA9B2B9F-E228-4F68-81A8-57607177BAC2},251,1405,424,30.2,230,183,79.6,1635,607,37.1
924,180301,13013180301,1803.01,ARC 20,2015-05-21T18:32:38.000Z,{BE3507D3-FA12-46E4-9B22-7AB55E5B26CB},86.1,658,171,26,65,35,53.8,723,206,28.5
925,180302,13013180302,1803.02,ARC 20,2015-05-21T18:32:38.000Z,{B47612C4-E549-44E2-82F0-CD914C493AA0},244.7,1827,409,22.4,278,127,45.7,2105,536,25.5
926,180105,13013180105,1801.05,ARC 20,2015-05-21T18:32:38.000Z,{663B4E30-D1A6-47F2-A119-74520F871F05},75.9,710,351,49.4,45,15,33.3,755,366,48.5
927,180104,13013180104,1801.04,ARC 20,2015-05-21T18:32:38.000Z,{9F2E9A51-AB84-4B6C-AFB7-9A0B95F547D4},3.8,568,187,32.9,73,34,46.6,641,221,34.5
928,180107,13013180107,1801.07,ARC 20,2015-05-21T18:32:38.000Z,{A9E571C2-4CF6-4568-908A-3C1AFA415B20},24.7,889,356,40,433,273,63,1322,629,47.6
929,180108,13013180108,1801.08,ARC 20,2015-05-21T18:32:38.000Z,{44B12FF1-1867-4FB4-9E11-AC1C28B6DE8C},-4.4,885,262,29.6,155,49,31.6,1040,311,29.9
930,120104,13223120104,1201.04,ARC 20,2015-05-21T18:32:38.000Z,{95979ADB-BCD3-4CF6-9B10-053BB99F7F98},30.1,744,122,16.4,88,34,38.6,832,156,18.8
931,120604,13223120604,1206.04,ARC 20,2015-05-21T18:32:38.000Z,{720B1737-30A5-4196-B7DC-CA70E81A4B0F},226.3,1645,549,33.4,54,48,88.9,1699,597,35.1
932,120601,13223120601,1206.01,ARC 20,2015-05-21T18:32:38.000Z,{5564A58E-AFAE-4731-ADE0-1BAF772E6F6B},366.3,1369,369,27,150,91,60.7,1519,460,30.3
933,120603,13223120603,1206.03,ARC 20,2015-05-21T18:32:38.000Z,{F8F9E31C-527D-40C5-B399-E8DD6C823E61},287.5,1562,310,19.8,825,290,35.2,2387,600,25.1
934,120501,13223120501,1205.01,ARC 20,2015-05-21T18:32:38.000Z,{ECD6C89E-4E30-470B-908A-B679C303573E},307.5,1921,578,30.1,378,251,66.4,2299,829,36.1
935,120203,13223120203,1202.03,ARC 20,2015-05-21T18:32:38.000Z,{FC30955B-C159-4A37-829A-6C0421B34AAC},203.8,1573,388,24.7,335,221,66,1908,609,31.9
936,120101,13223120101,1201.01,ARC 20,2015-05-21T18:32:38.000Z,{A16CC952-6B21-41F2-AAB3-0A340B88FF61},496.5,3749,1173,31.3,213,190,89.2,3962,1363,34.4
937,120502,13223120502,1205.02,ARC 20,2015-05-21T18:32:38.000Z,{16375365-A029-4DDA-9FAD-9AD564954028},174.7,2491,724,29.1,448,229,51.1,2939,953,32.4
938,120503,13223120503,1205.03,ARC 20,2015-05-21T18:32:38.000Z,{5B045F13-F79A-41D1-97DC-FC970230EF98},231.1,1359,189,13.9,201,152,75.6,1560,341,21.9
939,120605,13223120605,1206.05,ARC 20,2015-05-21T18:32:38.000Z,{AFFFECC6-A9D8-44AE-B196-FBF0BAB74DED},164.4,1636,519,31.7,199,81,40.7,1835,600,32.7
940,120602,13223120602,1206.02,ARC 20,2015-05-21T18:32:38.000Z,{9BFFD449-C8E6-42B9-8B66-5830BA0F89E0},310.7,2858,939,32.9,391,151,38.6,3249,1090,33.5
941,120204,13223120204,1202.04,ARC 20,2015-05-21T18:32:38.000Z,{713655DA-6AC0-4BCC-AC48-2937198EDA49},409.7,1604,547,34.1,645,451,69.9,2249,998,44.4
942,120301,13223120301,1203.01,ARC 20,2015-05-21T18:32:38.000Z,{BB924EE1-51C4-40A7-97F2-BD054D3B79A0},240.3,1215,227,18.7,555,297,53.5,1770,524,29.6
943,120303,13223120303,1203.03,ARC 20,2015-05-21T18:32:38.000Z,{94D6C03D-64FE-4FF9-8DC8-3C4931B84991},32.9,447,78,17.4,123,67,54.5,570,145,25.4
944,120102,13223120102,1201.02,ARC 20,2015-05-21T18:32:38.000Z,{984D8181-E3A1-4663-9D11-64CEDFA5550D},490.2,3157,929,29.4,164,57,34.8,3321,986,29.7
945,120103,13223120103,1201.03,ARC 20,2015-05-21T18:32:38.000Z,{5F6F55C9-8D2A-4495-BA56-62528A842DC1},189,2473,574,23.2,219,118,53.9,2692,692,25.7
946,120302,13223120302,1203.02,ARC 20,2015-05-21T18:32:38.000Z,{69CB0E18-898A-4272-9F97-921A1F0FFBDD},243.1,2368,563,23.8,1569,895,57,3937,1458,37
947,120202,13223120202,1202.02,ARC 20,2015-05-21T18:32:38.000Z,{A30EF4BA-E923-4F7B-B2BD-F3962A6A1285},463.1,1990,540,27.1,512,348,68,2502,888,35.5
948,120400,13223120400,1204,ARC 20,2015-05-21T18:32:38.000Z,{83BE033E-E2FD-49AA-824B-1D91CBADC37C},105.9,4854,1661,34.2,969,320,33,5823,1981,34
